____X_______________________________________________________
_X_XX_XXXXXXXXXXXXXXXXXXXXXXXXXXXXXXXXXXXXXXXXXXXXXXXXXXXXX_
_X__X_X_____________________________________________________
_X_XX_X_XXXXXXXXXXXXXXXXXXXXXXXXXXXXXXXXXXXXXXXXXXXXXXXXXXXX
_X__X_X_____________________________________________________
_XX_X_XXXXXXXXXXXXXXXXXXXXXXXXXXXXXXXXXXXXXXXXXXXXXXXXXXXXX_
BX____X_____________________________________________________
XXXXXXX_XXXXXX_XXXXXXXXXXXXXXXXXXXXXXXXXXX_XXXXXXXXXXXXXXXXX
______X_____________________________________________________
XXXXXXXXXXXXXXXXXXXXXXXXXXXXXXXXXXXXXXXXXXXXXXXXXXXXXXXXXXX_
____________________________________________________________
_XXXXXXXXX_XXXXXXXXXXXXXXXXXXXXXXXXX_XXXXXXXXXXXXXXXX_XXXXXX
____________________________________________________________
XXXXXXXXXXXXXXXX_XXXXXXXXXXXXXXXXXXXXXXXXX_XXXXXXXXXXXXXXXX_
____________________________________________________________
_XXXXXXXXXXXXXXXXXXXXXXXXXXXXXXXXXXXXXXXXXXXXXXXXXXXXXXXXXXX
____________________________________________________________
XXXXXXXXXXXXXXXXXXXXXXXXXXXXXX_XXXXXXXXXXXXXXXXXXXXXX_XXXXX_
____________________________________________________________
_XXXXXXXXXXXXXXXXXXXXXXXXXXXXXXXXXXXXXXXXXXXXXXXXXXXXXXXXXXX
____________________________________________________________
XXXXXXXXXXXXXXXX_XXXXXXXXXXXXXXXXXXXXXXXXXXXXXXXXXXXXXXXXXX_
____________________________________________________________
_XXXXXXXXXXXXXXXXXXXXXXXXXXXXX_XXXXXXXXXXXXXXXXXXXXXXXXXXXXX
____________________________________________________________
XXXXXXXXXXXXXXXXXXXXXXXXXXXXXX_XXXXXXXXXXXXXXXXXXXXXXXXXXXX_
____________________________________________________________
_XXXXXXXXX_XXXXXXXXXXXXXXXXXXX_XXXXXXXXXXXXXXXXXXXX_XXXXXXXX
____________________________________________________________
XXXXXXXXXXXXXXXXXXXXXXXXXXXXXXXXXXXXXXXXXXXXXXXXXXXXXXXXXXXT
