___XXXXXXXXXXXXXXXXXXXXXXXXXXXXXXXXXXXXXXXXXXXXXXXXXXXXXXXXXXXXXXXXXXXXXXXXXXXXXXXXXXXXXXXXXXXXXXXXXXXXXXXXXXXXXXXXXXXXXX
_B____X___________X___________X___________X______________X________X__X__X______________X___________X_____X_____X________X
X__X__X__X__XXXX__X__XXXX__XXXXXXX__X__XXXX__XXXX__X__XXXXXXXXXX__X__X__XXXX__X__XXXXXXXXXX__XXXXXXX__XXXX__XXXX__XXXXXXX
X__X_____X_____X__X_____X__X_____X__X__X__X__X_____X___________X__X___________X________X________X______________X__X_____X
XXXXXXXXXX__X__XXXX__XXXXXXX__X__XXXX__X__XXXXXXXXXXXXXXXXXXX__X__XXXX__XXXX__XXXX__X__X__XXXXXXX__XXXX__X__XXXX__X__X__X
X________X__X__X________X_____X__X__X_____X______________X__X___________X_____X_____X__X________X__X_____X__X__X_____X__X
X__XXXXXXX__XXXXXXX__XXXXXXX__XXXX__XXXX__XXXX__X__X__XXXX__XXXX__X__X__XXXXXXXXXXXXXXXX__X__XXXXXXX__XXXXXXX__XXXX__XXXX
X__X________X___________X________X__X_____X_____X__X___________X__X__X__X_____X___________X__X__X______________X__X__X__X
X__X__X__X__X__XXXXXXX__X__XXXXXXX__XXXX__XXXX__XXXX__X__X__XXXX__XXXX__X__XXXXXXX__X__XXXX__X__X__XXXXXXXXXXXXX__X__X__X
X__X__X__X___________X___________X__X__X_____X_____X__X__X__X________X_____X_____X__X_____X__X__X__X________X________X__X
X__XXXXXXXXXXXXX__XXXXXXXXXX__XXXX__X__X__XXXXXXXXXXXXX__X__X__XXXX__X__X__X__XXXXXXXXXXXXX__X__X__XXXX__XXXXXXX__X__X__X
X_____X_____X__X__X_____X_____X________X__X__X__X__X__X__X________X__X__X_____X_____X_____________________________X_____X
X__XXXXXXX__X__X__X__X__X__X__X__XXXXXXX__X__X__X__X__XXXX__XXXX__X__X__X__X__XXXX__XXXX__XXXXXXXXXX__XXXXXXX__XXXXXXXXXX
X_____X__X_____X__X__X_____X_____X________X_____X__X__X__X__X__X__X__X__X__X__X_____X________X_____X__X________X________X
X__XXXX__XXXX__XXXXXXXXXXXXX__XXXXXXX__XXXX__XXXX__X__X__XXXX__XXXX__X__XXXXXXX__X__XXXX__X__X__XXXX__X__XXXXXXXXXX__XXXX
X________X_____X_____X___________X__X___________X________X________X__X_____X_____X__X__X__X_____X__X__X___________X__X__X
XXXXXXX__X__X__XXXX__XXXX__XXXXXXX__XXXXXXX__XXXXXXXXXX__X__X__XXXXXXX__X__XXXXXXX__X__X__X__X__X__XXXXXXXXXX__XXXX__X__X
X__X________X________X_________________X_________________X__X_____X__X__X_________________X__X_____X__X__X__X___________X
X__X__X__XXXXXXXXXX__XXXXXXXXXX__XXXXXXX__XXXX__XXXX__XXXX__X__X__X__XXXXXXX__X__XXXXXXXXXX__X__XXXX__X__X__X__X__X__XXXX
X_____X__X__X__X___________X__X__X___________X_____X_____X__X__X_____X________X________X__X__X__X__X__X________X__X_____X
X__XXXXXXX__X__X__XXXXXXX__X__X__X__XXXXXXX__XXXX__X__XXXXXXXXXX__X__X__XXXXXXXXXX__XXXX__XXXXXXX__X__XXXX__XXXX__XXXXXXX
X_____X__X_____X_____X________X________X_____X_____X_____X________X________X________X__X__X_____X______________X__X_____X
XXXX__X__X__XXXXXXXXXXXXX__XXXX__XXXXXXX__XXXXXXX__XXXX__XXXXXXX__X__X__XXXX__X__X__X__X__X__XXXX__XXXXXXXXXXXXXXXXXXX__X
X_______________________X__X________X__X__X_____X_____X__X__X_____X__X__X_____X__X__X__X________X__X___________X_____X__X
X__XXXXXXXXXX__X__XXXX__XXXXXXXXXXXXX__X__XXXX__XXXXXXXXXX__XXXXXXXXXX__XXXX__XXXX__X__X__X__XXXX__X__XXXXXXX__XXXX__X__X
X__X_____X_____X__X_____X_______________________X_____X___________X_____X_____X_____X_____X__X_____X__X_____X__X__X_____X
XXXX__X__XXXXXXXXXX__XXXX__XXXXXXXXXXXXX__XXXXXXXXXX__XXXX__XXXX__XXXX__XXXX__XXXXXXXXXX__XXXXXXXXXXXXXXXX__X__X__XXXX__X
X_____X__X_____X__X__X_____X__X___________X_____X________X_____X___________X_________________X__X______________X________X
X__XXXXXXXXXX__X__X__X__XXXX__XXXXXXX__XXXX__X__XXXX__X__XXXXXXXXXX__XXXX__XXXXXXX__X__XXXX__X__XXXXXXXXXXXXX__X__X__XXXX
X_____X__X__X___________X_____X___________X__X__X__X__X___________X__X_____X_____X__X__X_____X__X__X______________X__X__X
XXXX__X__X__X__XXXXXXX__XXXX__XXXXXXXXXXXXXXXX__X__X__XXXXXXXXXX__X__XXXX__X__XXXX__XXXXXXX__X__X__X__XXXX__X__XXXXXXX__X
X_____X_____X_____X_____X______________X_____X_____X__X_____X__X__X_____X__X_____X_____X__X_____X________X__X___________X
X__X__X__X__X__XXXXXXX__X__XXXXXXX__X__XXXX__X__XXXX__XXXX__X__XXXXXXXXXX__XXXX__X__X__X__X__X__XXXX__X__XXXXXXX__XXXX__X
X__X_____X_____X__X_____X_____X_____X_____X______________X___________X_____X________X_____X__X_____X__X_____X_____X_____X
X__XXXXXXXXXX__X__XXXX__XXXXXXXXXX__X__X__XXXX__X__X__X__X__X__X__XXXX__X__XXXXXXXXXX__XXXXXXXXXXXXX__X__X__X__XXXXXXX__X
X_____X________X________X___________X__X________X__X__X_____X__X_____X__X___________X_____X_____X_____X__X__X_____X_____X
X__XXXXXXXXXXXXX__X__XXXXXXXXXX__X__XXXXXXX__XXXX__XXXXXXXXXX__XXXX__XXXX__XXXXXXXXXXXXXXXX__XXXX__XXXX__X__XXXXXXXXXX__X
X__X________X__X__X__X_____X_____X_____X_____X__X________X________X__X_____X_____X________X__X__X__X__X__X________X_____X
X__XXXXXXX__X__XXXX__XXXX__X__XXXX__XXXXXXXXXX__XXXX__XXXXXXXXXXXXX__X__X__XXXX__X__XXXX__X__X__X__X__XXXXXXXXXXXXXXXXXXX
X_____X_______________________X__X__X_____X__X___________X_____X_____X__X________X__X________X__X______________X_____X__X
XXXX__X__XXXXXXX__XXXXXXXXXX__X__X__X__X__X__X__XXXX__X__X__XXXXXXXXXX__XXXX__XXXXXXX__XXXXXXX__X__X__XXXXXXXXXXXXX__X__X
X_____X__X_____X___________X__X__X__X__X__X__X_____X__X__X_____X_____X__X__X_____X_____X________X__X_________________X__X
XXXXXXXXXX__XXXX__XXXXXXXXXXXXX__X__XXXX__X__X__X__X__X__X__X__XXXX__XXXX__XXXX__X__XXXX__XXXXXXXXXXXXX__XXXXXXXXXXXXX__X
X________X__X________X_____X__X________X________X__X__X__X__X_____X________X______________X_____X_____X_____X__X________X
X__XXXXXXX__X__XXXX__X__XXXX__XXXX__XXXX__XXXX__X__X__X__X__X__XXXXXXXXXX__X__XXXXXXXXXXXXXXXX__X__XXXX__X__X__X__X__XXXX
X________X________X_____X__X_____X_____X__X_____X__X__X__X__X_____X___________X__X_________________X__X__X_____X__X_____X
X__XXXXXXXXXXXXX__X__X__X__XXXX__X__XXXX__XXXXXXXXXX__XXXXXXX__X__X__XXXXXXX__X__X__X__XXXXXXX__XXXX__X__XXXXXXX__XXXX__X
X_____X_____X__X__X__X________X_____X_____X________X__X__X__X__X_____X__X___________X_____X___________X__X__X__X_____X__X
XXXX__X__XXXX__XXXX__X__X__XXXXXXX__X__XXXXXXX__XXXX__X__X__XXXX__XXXX__XXXXXXXXXX__XXXX__XXXX__XXXX__X__X__X__X__XXXX__X
X________X________X__X__X_____X_____X________X_____X______________X_____X__X__X________X_____X__X________X_____X__X_____X
XXXX__XXXX__XXXXXXXXXX__XXXXXXX__XXXXXXXXXXXXX__XXXX__X__X__X__XXXXXXX__X__X__X__XXXXXXX__X__XXXXXXX__X__XXXX__X__XXXXXXX
X___________X_____X________X_____X_____X_____X________X__X__X__X__X__X________X________X__X__X________X__X___________X__X
XXXX__XXXX__X__XXXXXXX__XXXXXXX__X__XXXXXXX__XXXXXXX__XXXX__X__X__X__X__XXXX__XXXXXXX__X__XXXXXXXXXXXXXXXX__XXXX__X__X__X
X_____X___________X________X________X__X_________________X__X__X__X_____X___________X__X__X_________________X_____X_____X
X__X__XXXXXXXXXXXXX__XXXXXXXXXXXXX__X__XXXXXXX__X__X__X__XXXX__X__X__XXXX__XXXXXXXXXX__XXXX__X__X__XXXXXXX__X__X__XXXX__X
X__X_____X_____X__X_____X__X________X_____X_____X__X__X__X__X___________X_____X_____X__X_____X__X__X_____X__X__X__X_____X
X__XXXXXXX__X__X__X__XXXX__XXXXXXX__XXXX__XXXXXXXXXXXXXXXX__X__XXXX__X__XXXXXXXXXX__X__XXXXXXXXXX__X__XXXXXXXXXX__XXXX__X
X_____X_____X_____X__X__X_____X__X__X___________X__X__X_____X__X_____X_____X_____X___________X______________X________X__X
X__XXXX__XXXXXXXXXX__X__X__X__X__XXXXXXX__X__XXXX__X__XXXX__X__XXXXXXXXXXXXXXXX__X__X__X__XXXX__X__XXXXXXXXXXXXX__X__X__X
X__X__X_____X______________X_____X_____X__X_____X_____X________X_________________X__X__X________X__X________X__X__X__X__X
X__X__X__X__XXXXXXXXXXXXX__XXXXXXX__XXXX__XXXXXXX__XXXX__XXXXXXXXXX__X__XXXX__XXXX__XXXX__XXXXXXXXXX__XXXX__X__XXXXXXXXXX
X__X_____X______________X________X___________X__X______________X_____X__X__X___________X__X___________X__X__X___________X
X__XXXX__XXXXXXX__X__XXXX__X__X__X__XXXX__X__X__X__X__XXXX__XXXXXXX__XXXX__XXXXXXXXXXXXXXXXXXX__X__XXXX__XXXX__XXXXXXX__X
X_____X_____X_____X__X_____X__X__X__X__X__X_____X__X__X________X____________________X________X__X________X__X_____X__X__X
XXXX__X__X__XXXX__X__XXXX__XXXXXXX__X__X__X__X__X__XXXXXXXXXXXXX__XXXXXXX__XXXXXXXXXX__X__XXXXXXX__X__X__X__X__XXXX__X__X
X________X__X_____X______________X__X_____X__X__X__X_____X__X__X__X__X___________X_____X________X__X__X________X________X
XXXX__X__XXXXXXX__XXXX__XXXXXXXXXXXXX__XXXXXXXXXX__XXXX__X__X__XXXX__XXXX__XXXX__XXXXXXXXXX__X__X__XXXXXXXXXXXXXXXX__XXXX
X__X__X__X________X_____X__X__X__X__X_____X_____X__X________X__X________X__X__X_____X________X__X___________X________X__X
X__X__XXXX__X__XXXXXXX__X__X__X__X__X__XXXXXXX__XXXX__X__XXXX__XXXXXXX__XXXX__X__XXXXXXX__X__XXXX__XXXXXXX__XXXXXXXXXX__X
X__X__X_____X________X__X___________X__X________X_____X__X_____X________X________X________X_____X__X__X________X__X_____X
X__XXXXXXXXXXXXX__XXXX__X__XXXXXXXXXX__XXXX__X__X__X__X__X__XXXX__X__XXXXXXXXXX__XXXXXXXXXX__XXXXXXX__XXXX__XXXX__X__X__X
X__X__X______________X__X________X_____X_____X__X__X__X_____X_____X________X________X__X________X__X__X________X__X__X__X
X__X__X__XXXX__X__X__XXXXXXX__XXXXXXX__XXXXXXX__XXXX__XXXX__X__XXXXXXX__XXXXXXXXXX__X__X__X__X__X__X__XXXX__X__X__XXXX__X
X___________X__X__X__X__X________X__X_____X________X_____X__X_____X_____X__X______________X__X______________X__X__X_____X
X__XXXXXXXXXXXXX__XXXX__X__XXXXXXX__X__XXXXXXX__X__X__XXXXXXX__XXXX__X__X__XXXXXXXXXXXXXXXX__XXXX__XXXX__XXXXXXX__XXXX__X
X__X________X__X________X___________X___________X_____X________X_____X_____X__X_____X__X_____X________X__X___________X__X
X__XXXX__X__X__XXXX__X__XXXX__XXXXXXX__X__XXXXXXX__XXXXXXX__XXXX__XXXXXXX__X__X__XXXX__X__XXXXXXXXXX__XXXX__X__X__XXXX__X
X_____X__X_____X_____X__X________X__X__X__X__X________X__X_____X__X__X_________________X__X_____X________X__X__X_____X__X
X__XXXXXXX__X__X__XXXX__X__XXXXXXX__X__X__X__X__X__XXXX__XXXXXXXXXX__X__XXXX__XXXX__X__X__X__X__XXXXXXX__XXXXXXX__X__X__X
X__X________X_____X____________________X_____X__X______________X________X________X__X_____X__X____________________X_____X
XXXXXXXXXXXXXXXXXXXXXXXXXXXXXXXXXXXXXXXXXXXXXXXXXXXXXXXXXXXXXXXXXXXXXXXXXXXXXXXXXXXXXXXXXXXXXXXXXXXXXXXXXXXXXXXXXXXXXX_TX
