BGGGGGGGGGGGGGGG
GWWWGWWWWWWWWWWG
GWGGGGGGGGGGGGWG
GWGWWWWWWWWWWWWG
WGGWGGGGGGGGGGGG
GGGWGWGGGGGGGGGG
GGGGGWGGGGGGGGGT
