___XXXXXXXXXXXXXXXXXXXXXXXXXXXXXXXXXXXXXXXXXXXXXXXXXXXXXXXXXXXXXXXXXXXXXXXXXXXXXXXXXXXXXXXXXXXXXXXXXXXXXXXXXXXXXXXXXXXXXXXXXXXXXXXXXXXXXXXXXXXXXXXXXXXX
______X__________________________X______________X_____X_____X______________X__X__X___________X_____X__X______________X__X_____X__X__X________X_____X_BX
X__XXXX__XXXX__XXXXXXXXXXXXX__XXXXXXXXXX__XXXXXXXXXX__XXXX__X__XXXXXXX__X__X__X__XXXX__XXXX__XXXX__X__X__XXXX__XXXX__X__XXXX__X__X__XXXX__XXXX__XXXX__X
X________X__X__X___________X_____X__X__X________X___________X_____X__X__X__X________X_____X__X_____X_____X__X_____X________X_____X_____X_____X_____X__X
X__XXXXXXX__X__XXXXXXXXXX__X__X__X__X__XXXX__XXXXXXX__X__X__XXXXXXX__X__XXXX__XXXX__XXXX__XXXXXXX__X__X__X__X__XXXXXXXXXXXXXXXX__XXXX__X__X__XXXX__X__X
X________X_____X__X__X________X__X______________X__X__X__X__X__X__X________X__X__X____________________X__X____________________X___________X___________X
X__X__XXXX__X__X__X__X__X__XXXXXXXXXXXXXXXX__X__X__XXXX__XXXX__X__XXXXXXX__X__X__X__XXXX__XXXXXXXXXXXXXXXXXXX__XXXX__XXXXXXXXXX__X__XXXXXXX__XXXX__XXXX
X__X__X_____X________X__X__X_____X_____X_____X______________X_____X______________X__X__X________X________X__X_____X__X__X_____X__X__X_____X_____X_____X
X__X__XXXX__XXXX__XXXXXXXXXX__XXXX__X__XXXX__XXXX__X__XXXXXXX__XXXXXXXXXXXXX__XXXXXXX__X__XXXXXXX__XXXXXXX__X__XXXXXXX__X__X__X__X__X__XXXX__XXXXXXX__X
X__X__X________X_____X________X_____X________X__X__X_____X_______________________X______________X_____X___________X________X__X__X_____X___________X__X
XXXXXXXXXXXXXXXXXXX__X__X__XXXX__XXXXXXXXXX__X__X__XXXX__XXXXXXX__XXXX__X__XXXXXXX__X__XXXXXXXXXXXXX__XXXXXXXXXX__X__XXXXXXX__XXXXXXXXXXXXXXXX__X__XXXX
X________X___________X__X_____X_____X__X__X_____X__X__X__X_____X_____X__X__X__X_____X__X__X______________X__X______________X__X_________________X_____X
X__XXXXXXXXXXXXXXXX__X__X__X__X__XXXX__X__XXXXXXXXXX__XXXXXXX__X__X__XXXXXXX__XXXX__XXXX__X__XXXX__X__XXXX__XXXXXXX__XXXX__XXXXXXXXXXXXX__XXXX__XXXXXXX
X________X___________X__X__X__X____________________X_____X________X__X__X_____X___________X__X__X__X__X_____X_____X__X________X________X__X___________X
X__X__X__XXXX__XXXX__X__XXXX__X__X__X__XXXX__XXXXXXX__XXXX__XXXX__XXXX__X__X__X__XXXX__XXXXXXX__X__XXXXXXX__XXXX__X__XXXXXXXXXXXXX__XXXXXXX__XXXXXXX__X
X__X__X_____X_____X_____X_____X__X__X__X_____X_____X_____X_____X________X__X__X_____X________X_________________X___________X__X_____X__X_____X_____X__X
XXXXXXXXXX__XXXX__XXXX__X__X__XXXX__X__XXXXXXX__XXXX__XXXXXXX__X__XXXXXXXXXX__XXXX__X__XXXXXXXXXX__X__XXXXXXXXXXXXX__X__XXXX__X__XXXX__XXXX__XXXX__XXXX
X________X_____X_____X__X__X__X__X__X__X__X___________X_____X__X_____X_____X_____X__X_____X_____X__X__X_____X__X_____X__X__X______________X__X_____X__X
X__X__X__X__X__X__XXXX__XXXXXXX__XXXX__X__XXXX__X__XXXXXXX__XXXXXXX__XXXX__X__XXXX__XXXXXXX__X__X__XXXXXXX__X__XXXX__XXXX__XXXXXXX__XXXX__X__X__XXXX__X
X__X__X__X__X________X_____X_____X______________X________X________X___________X_____X________X_____X_________________X___________X_____X_____X________X
X__XXXXXXXXXX__XXXXXXX__XXXX__X__XXXXXXXXXX__X__X__XXXXXXX__XXXXXXXXXXXXXXXXXXX__XXXXXXXXXX__XXXX__X__XXXX__XXXXXXX__XXXX__XXXXXXX__X__XXXX__XXXX__XXXX
X________X________X__X________X_____X_____X__X__X___________X__X_____X___________X__X_____X__X___________X________X__X________X__X__X__X_____X__X__X__X
X__XXXXXXX__XXXXXXX__XXXXXXX__XXXX__XXXX__X__XXXX__XXXX__X__X__X__X__XXXXXXX__XXXX__XXXX__X__XXXXXXXXXX__XXXX__XXXX__XXXX__XXXX__XXXXXXX__X__X__X__X__X
X______________X__X_____X_____X__X___________X________X__X_____X__X___________X_____X_____X___________X_____X_____X__X_____X________X_____X___________X
XXXXXXXXXXXXX__X__X__X__XXXX__X__X__XXXX__XXXXXXXXXXXXXXXX__XXXX__X__X__XXXX__X__XXXXXXX__XXXX__X__XXXX__XXXXXXXXXXXXXXXX__X__XXXXXXXXXX__XXXXXXXXXX__X
X__X_____X___________X_____X_____X__X________X_____X_____X________X__X__X__X_____X___________X__X_____X__X____________________X______________X________X
X__XXXX__X__XXXXXXX__XXXXXXX__X__XXXX__XXXX__X__XXXXXXX__XXXX__XXXX__XXXX__XXXXXXXXXXXXX__XXXXXXXXXX__X__XXXX__X__X__XXXXXXXXXXXXX__XXXXXXXXXX__X__XXXX
X__X_____X__X_____X__X_____X__X__X_____X_____X__X_____X__X__X_____X__X______________X_____X__X________X_____X__X__X_______________________X_____X__X__X
X__XXXX__X__X__X__X__XXXX__X__XXXX__XXXXXXXXXX__X__XXXX__X__X__X__X__X__XXXXXXX__X__XXXX__X__XXXX__XXXX__XXXXXXX__X__X__X__XXXXXXXXXX__X__XXXX__X__X__X
X___________X__X_____X_____X__X__X__X__X___________X__X________X__X_____X__X__X__X___________X__X__X__X__X_____X__X__X__X________X_____X__X__X__X_____X
X__XXXXXXX__X__XXXX__X__XXXXXXX__XXXX__XXXX__XXXX__X__XXXXXXX__XXXXXXXXXX__X__XXXX__XXXXXXX__X__XXXX__XXXX__XXXX__XXXX__XXXX__XXXX__X__XXXX__XXXXXXXXXX
X_____X__X__X__X_____X________X_____X__X________X__X___________X________X________X__X__X________X__X______________X________X__X__X__X__X__X__X__X__X__X
X__XXXX__X__XXXXXXXXXX__XXXXXXX__XXXX__XXXX__XXXXXXX__XXXXXXXXXXXXX__X__XXXX__XXXXXXX__XXXXXXX__X__XXXX__X__X__XXXXXXXXXXXXXXXX__XXXXXXX__X__X__X__X__X
X________X_____X________________________________X_____X_____X________X__X__X__X__X__X___________X________X__X__X___________X_____X_____X________X_____X
XXXXXXX__XXXX__XXXXXXX__X__X__XXXX__XXXX__XXXXXXX__X__X__XXXXXXX__XXXXXXX__X__X__X__XXXX__XXXXXXX__XXXX__XXXXXXX__XXXX__X__X__XXXX__XXXXXXX__XXXXXXX__X
X__X_____X________X_____X__X_____X_____X________X__X_____X__X___________X__X__X_________________X__X________X__X__X_____X__X__X_____X_____X_____X_____X
X__XXXX__X__XXXX__X__X__XXXXXXXXXXXXX__XXXX__X__XXXX__XXXX__XXXXXXXXXX__X__X__XXXX__XXXXXXXXXXXXX__XXXXXXX__X__XXXX__XXXX__X__X__XXXXXXX__XXXX__XXXX__X
X________X__X________X__X_________________X__X__X___________X________X___________X__X_____X________X________X________X__X___________X_________________X
X__X__XXXXXXX__XXXX__XXXX__XXXXXXXXXXXXXXXX__XXXXXXX__XXXX__XXXX__XXXX__XXXX__XXXXXXX__X__X__X__XXXXXXXXXX__X__X__X__X__X__XXXX__XXXX__XXXXXXXXXXXXX__X
X__X__X________X__X__X_____X________X__X_____X___________X___________X_____X__X_____X__X_____X___________X_____X__X_____X__X_____X______________X__X__X
X__X__XXXX__X__X__X__XXXXXXX__XXXX__X__XXXXXXXXXX__X__X__XXXXXXX__XXXX__X__X__XXXX__XXXX__X__XXXXXXX__XXXXXXX__XXXXXXX__XXXX__XXXX__XXXXXXX__XXXX__X__X
X__X_____X__X_____X__X___________X___________X_____X__X_____X__X________X__X___________X__X_____X__X__X__X__X_____X________X__X___________X__X_____X__X
XXXXXXX__XXXXXXX__XXXXXXXXXXXXXXXXXXX__XXXX__XXXXXXX__XXXX__X__XXXXXXXXXXXXX__X__XXXX__XXXXXXXXXX__XXXX__X__X__XXXXXXXXXXXXXXXXXXX__XXXXXXX__XXXX__X__X
X_____X________X__X___________X_____X_____X__X__X_____X_____X___________X_____X__X__X___________X__X________X__X__X__X__X__X__X__X__X________X________X
XXXX__X__XXXXXXX__XXXXXXX__X__X__XXXXXXXXXX__X__XXXXXXXXXX__XXXXXXXXXX__XXXX__XXXX__XXXXXXXXXXXXX__XXXX__X__X__X__X__X__X__X__X__XXXXXXXXXXXXX__XXXX__X
X__X___________X__X__X_____X_____X_____X________X________X__X________X__X______________X__X__X__X_____X__X________X___________X__X_____X_____X__X_____X
X__XXXX__XXXX__XXXX__XXXX__XXXXXXX__X__XXXX__XXXX__XXXXXXXXXX__XXXXXXX__X__XXXX__X__XXXX__X__X__XXXX__XXXXXXX__X__XXXX__XXXX__X__X__XXXX__X__XXXXXXX__X
X________X__X__X______________X_____X__X___________X__X_____X________X________X__X_____X__X_____X_____X________X__X________X_____X________X___________X
XXXXXXXXXX__XXXXXXX__X__XXXXXXX__X__XXXX__XXXX__XXXX__X__XXXXXXX__X__X__XXXXXXXXXX__X__X__X__XXXX__XXXX__XXXXXXX__X__X__XXXXXXX__XXXX__XXXX__X__XXXX__X
X_________________X__X_____X_____X__X__X_____X__X___________X_____X_____X________X__X__X___________X__X__X__X________X________X_____X__X__X__X_____X__X
X__X__X__X__XXXX__X__XXXXXXXXXX__XXXX__X__XXXXXXX__X__XXXX__XXXXXXXXXX__XXXXXXX__X__XXXX__XXXXXXX__X__X__X__XXXXXXX__XXXX__XXXX__X__X__X__XXXX__X__XXXX
X__X__X__X_____X________X__X__X________X_____X_____X_____X__X__X___________X__X______________X________X___________X__X_____X_____X__X_____X__X__X_____X
XXXXXXXXXXXXXXXX__X__XXXX__X__X__XXXXXXX__X__XXXXXXX__XXXX__X__XXXX__XXXXXXX__X__XXXX__X__X__XXXX__XXXXXXXXXX__X__XXXX__XXXXXXXXXX__X__XXXX__XXXXXXX__X
X___________X_____X_____X__X________X_____X__X________X_____X_____X__X___________X_____X__X_____X__X_____X_____X_____X________X________X__X_____X_____X
X__X__X__XXXX__XXXXXXXXXX__XXXX__X__XXXX__X__XXXX__XXXXXXX__X__X__XXXX__XXXXXXX__X__XXXXXXX__XXXX__X__XXXXXXXXXXXXX__XXXX__XXXXXXXXXX__X__X__XXXXXXXXXX
X__X__X_____X___________X________X__X_____X__X__X__X________X__X__X________X_____X__X________X__X__X__X__X__X________X___________X__X__X_____X________X
XXXX__X__XXXX__XXXX__X__X__XXXX__X__X__XXXXXXX__X__X__X__X__X__XXXX__X__XXXXXXX__XXXXXXXXXXXXX__X__X__X__X__XXXX__XXXX__XXXXXXXXXX__X__X__X__XXXXXXX__X
X__X__X__X__X__X_____X__X_____X__X_____X__X________X__X__X________X__X__X__X__X________X__X________X___________X_____X_____X_____X_____X__X_____X__X__X
X__X__X__X__XXXX__XXXX__X__XXXXXXX__XXXX__X__XXXXXXX__XXXXXXX__XXXXXXX__X__X__XXXXXXX__X__XXXXXXXXXXXXX__X__X__XXXXXXX__X__XXXX__X__XXXXXXX__XXXX__X__X
X_____X______________X_____X________X__X_____X_____X__X__X__X___________X__X_____X__X______________X_____X__X___________X_____X___________X________X__X
XXXX__XXXXXXX__X__XXXXXXXXXX__XXXXXXX__XXXX__XXXX__XXXX__X__X__XXXXXXX__X__X__XXXX__XXXXXXX__XXXX__X__XXXX__X__X__XXXXXXX__XXXXXXX__XXXX__X__XXXX__X__X
X_____X__X__X__X________X________X________X________X__X_____X________X____________________X__X_____X_____X__X__X________X__X___________X________X_____X
XXXXXXX__X__X__XXXX__XXXX__XXXX__X__X__XXXXXXXXXX__X__XXXX__X__X__XXXX__X__XXXXXXX__XXXX__XXXX__XXXXXXXXXXXXX__X__XXXX__XXXX__XXXX__XXXXXXXXXXXXXXXX__X
X__X________X__X________X__X__X__X__X_____X_____X_____X__X_____X__X_____X_____X__X_____X__X________X__X__X__X__X__X__X__X_____X________X_____X__X_____X
X__XXXX__X__X__XXXX__X__XXXX__XXXXXXX__X__X__XXXX__X__X__X__XXXXXXXXXXXXX__X__X__X__XXXXXXX__X__X__X__X__X__X__XXXX__XXXXXXX__X__XXXXXXXXXX__X__XXXX__X
X________X__X__X_____X_____X__X________X__X________X_____X__X__X_____X_____X__X_____X_____X__X__X____________________X__X_____X________X_____X_____X__X
XXXXXXX__XXXXXXX__XXXX__XXXX__X__XXXXXXX__X__X__XXXX__XXXXXXX__X__X__X__XXXX__XXXXXXXXXX__X__XXXX__XXXXXXX__X__X__X__X__XXXXXXX__XXXX__X__XXXXXXX__XXXX
X_____X________X__X__X__X__X___________X__X__X__X________X__X__X__X__X_____X___________X_____X_____X__X_____X__X__X__X__X___________X_____X___________X
X__XXXX__XXXX__X__X__X__X__X__X__XXXXXXX__XXXX__XXXXXXXXXX__X__X__XXXX__X__XXXXXXX__X__XXXXXXXXXXXXX__X__XXXXXXX__X__X__XXXXXXX__XXXXXXX__X__XXXX__XXXX
X_____X_____X_____X__X_____X__X________X_____X___________X_____X__X__X__X________X__X__X______________X__X________X_____X__X_____X______________X_____X
XXXX__X__XXXX__XXXX__X__XXXX__X__X__XXXX__XXXX__X__XXXX__X__XXXX__X__XXXXXXX__XXXX__XXXXXXXXXXXXX__X__XXXXXXXXXX__X__X__X__X__X__XXXX__XXXXXXXXXXXXX__X
X__X_____X__X_____X__X_____X__X__X__X_____X_____X__X__X_____X____________________X________X________X__X__X__X_____X__X__X_____X_____X_____X_____X_____X
X__XXXXXXX__XXXX__X__XXXXXXXXXXXXXXXXXXX__XXXXXXX__X__X__XXXXXXXXXXXXXXXXXXXXXXXXX__XXXX__XXXXXXX__XXXX__X__XXXX__XXXX__XXXXXXX__X__XXXX__X__X__X__XXXX
X____________________X_____X________X___________X__X_____X_____X__X__X__X________X_____X______________X_____X__X__X_____X________X__X__X_____X__X_____X
X__XXXXXXX__XXXX__X__X__XXXXXXXXXX__X__X__X__X__XXXX__XXXX__X__X__X__X__XXXXXXX__XXXXXXX__XXXXXXXXXXXXXXXX__X__X__X__XXXX__XXXXXXX__X__X__X__XXXXXXXXXX
X__X_____X_____X__X________X_____X__X__X__X__X______________X__X__X_____X_____X__X________X_____X__X______________X__X_____X________X__X__X_____X_____X
XXXXXXX__X__XXXX__XXXXXXX__XXXX__X__X__XXXXXXX__XXXX__X__XXXXXXX__XXXX__XXXX__X__X__XXXXXXX__XXXX__XXXX__XXXXXXXXXXXXXXXXXXXXXX__XXXX__X__XXXX__X__X__X
X___________X________X__X___________X_____X__X__X_____X__X________X_____X__X___________X________X_____X__X__X__X_____X_____X__X__X________X________X__X
XXXX__XXXXXXX__XXXX__X__XXXXXXXXXX__X__XXXX__XXXX__XXXXXXXXXXXXX__XXXX__X__XXXXXXX__XXXXXXXXXX__XXXX__X__X__X__X__XXXXXXX__X__XXXX__X__XXXXXXXXXXXXX__X
X_____X__X_____X_____X__X_____X_____X________X___________X__X________X_____X_____X_____X_______________________X__X_____X__X_____X__X___________X_____X
XXXX__X__XXXX__XXXXXXX__X__X__X__X__X__XXXX__XXXXXXX__XXXX__X__XXXX__X__XXXXXXX__X__XXXXXXXXXXXXXXXX__XXXXXXX__X__X__XXXX__X__XXXXXXX__XXXXXXXXXX__X__X
X________X______________X__X_____X__X__X__X__X_____X________X_____X__X________X_____X___________X_____X______________X________X_____X_____X_____X__X__X
X__X__XXXXXXX__X__X__XXXXXXXXXX__XXXX__X__XXXX__XXXXXXXXXXXXX__X__XXXXXXX__X__XXXX__X__XXXX__XXXXXXX__XXXXXXX__X__XXXXXXX__XXXXXXX__XXXXXXXXXX__XXXXXXX
X__X_____X__X__X__X________X___________X__X__X__X__X__X_____X__X_____X_____X_____X__X__X__X__X__X________X_____X__X__X__X________X__X__X______________X
X__X__XXXX__XXXXXXX__X__XXXXXXXXXXXXX__X__X__X__X__X__XXXX__X__X__X__XXXXXXX__X__XXXX__X__XXXX__XXXXXXXXXXXXXXXX__X__X__XXXX__X__X__X__XXXXXXX__X__XXXX
X__X__X__X___________X__X_____X______________X_____X___________X__X__X__X_____X__X______________X_________________X___________X__X__X__X__X_____X__X__X
X__XXXX__X__XXXXXXX__XXXX__XXXXXXX__XXXX__X__XXXX__XXXX__XXXX__XXXXXXX__X__X__XXXX__XXXX__XXXXXXX__XXXX__XXXX__XXXX__XXXX__XXXX__X__X__X__XXXX__XXXX__X
X__X_____X__X__X__X_____X_____X_____X_____X_____X________X_________________X__X__X_____X__X________X________X__X__X_____X__X__X________X______________X
X__XXXX__XXXX__X__X__X__X__XXXXXXX__XXXXXXX__XXXXXXX__X__XXXX__X__XXXX__XXXX__X__X__XXXXXXXXXXXXX__XXXX__X__X__X__XXXXXXXXXX__X__XXXX__XXXXXXXXXXXXX__X
X________X_____X__X__X__X_____X________X___________X__X__X__X__X__X__X_____X________X__X__X_____X_____X__X__X_____X__X__X__X__X_____X________X________X
XXXXXXXXXXXXX__X__X__X__X__XXXXXXX__X__XXXX__XXXXXXXXXXXXX__X__XXXX__X__XXXX__X__XXXX__X__X__X__XXXX__X__XXXXXXXXXX__X__X__X__XXXXXXX__X__X__X__XXXX__X
X________X________X__X___________X__X__X________X______________X________X__X__X__X__X________X__X_____X__X______________X______________X__X________X__X
X__XXXX__X__X__X__X__X__XXXX__X__XXXXXXX__XXXX__XXXX__X__X__XXXXXXXXXXXXX__XXXX__X__X__XXXXXXXXXX__X__XXXXXXX__X__XXXXXXXXXX__XXXX__XXXXXXXXXX__XXXX__X
X__X__X_____X__X_____X_____X__X__X_____X__X__X_____X__X__X__X________X__X_____X__X_________________X___________X________X__X__X__X________X_____X_____X
XXXX__X__XXXXXXX__X__XXXX__X__X__X__X__X__X__XXXXXXXXXXXXXXXXXXXXXX__X__X__X__X__XXXX__XXXX__X__X__XXXX__XXXXXXXXXXXXX__X__XXXX__XXXX__XXXX__X__X__X__X
X__X________X_____X__X_____X__X_____X__X_____X_____X___________X___________X__X___________X__X__X_____X________X__X_____X_____X___________X__X__X__X__X
X__X__XXXXXXXXXXXXX__XXXX__XXXXXXXXXXXXX__XXXX__X__X__XXXXXXX__XXXXXXX__X__X__XXXXXXXXXX__XXXXXXXXXXXXX__X__XXXX__XXXX__XXXX__X__XXXX__XXXX__XXXX__XXXX
X___________X_____X_____X______________X__X_____X___________X_____X__X__X__X__X_____X_____X__X__X_____X__X__X__X__X___________X__X__X__X__X__X_____X__X
X__XXXXXXX__XXXX__X__X__X__XXXX__X__XXXX__X__XXXX__XXXX__XXXX__X__X__X__X__XXXXXXX__X__X__X__X__X__XXXXXXX__X__X__XXXXXXXXXX__XXXX__X__X__XXXXXXX__X__X
XT____X_____X________X__X_____X__X__X________X________X__X_____X__X_____X______________X_________________X________X____________________X_______________
XXXXXXXXXXXXXXXXXXXXXXXXXXXXXXXXXXXXXXXXXXXXXXXXXXXXXXXXXXXXXXXXXXXXXXXXXXXXXXXXXXXXXXXXXXXXXXXXXXXXXXXXXXXXXXXXXXXXXXXXXXXXXXXXXXXXXXXXXXXXXXXXXXXX___
