BGGWWWWWWWWWWWWWWWWWWWWWWWWWWWWWWWWWWWWWWWWWWWWWWWWWWWWWWWWWW
GGGWGGGGGGGGGGGGGGWGGGGGWGGGGGWGGGGGGGGGGGGGGWGGWGGWGGWGGGGGW
WGGWGGWWWWWWWWWWGGWGGWGGWGGWGGWWWWGGWWWWWWWGGWGGWGGWGGWGGWWWW
WGGGGGWGGGGGGGGGGGWGGWGGGGGWGGWGGGGGWGGGGGWGGWGGWGGWGGGGGGGGW
WWWWWWWWWWWWWWWWGGWGGWGGWWWWWWWWWWGGWWWWGGWWWWGGWGGWGGWWWWGGW
WGGGGGGGGGGGGGGGGGGGGWGGGGGWGGWGGWGGGGGGGGGGGGGGGGGGGGGGGWGGW
WGGWWWWGGWGGWWWWGGWWWWGGWGGWGGWGGWGGWGGWWWWWWWWWWWWWWWWWWWGGW
WGGGGGWGGWGGWGGWGGGGGWGGWGGGGGGGGGGGWGGGGGWGGGGGGGGWGGGGGGGGW
WGGWGGWWWWGGWGGWWWWGGWWWWWWWWWWGGWWWWWWWWWWGGWWWWWWWWWWGGWWWW
WGGWGGGGGWGGGGGWGGWGGWGGWGGWGGWGGGGGGGGWGGWGGGGGWGGWGGGGGGGGW
WWWWWWWWWWWWWWWWGGWGGWGGWGGWGGWWWWWWWGGWGGWGGWWWWGGWGGWGGWGGW
WGGGGGGGGWGGGGGGGGWGGWGGGGGGGGGGGWGGGGGGGGWGGWGGGGGWGGWGGWGGW
WGGWWWWWWWGGWGGWWWWGGWGGWWWWGGWWWWGGWGGWGGWGGWWWWGGWWWWWWWGGW
WGGGGGWGGWGGWGGWGGGGGWGGWGGWGGGGGWGGWGGWGGGGGGGGWGGGGGGGGGGGW
WGGWWWWGGWWWWGGWWWWWWWGGWGGWGGWGGWGGWGGWWWWGGWWWWWWWWWWWWWWWW
WGGWGGWGGGGGWGGWGGGGGWGGGGGWGGWGGWGGWGGWGGWGGGGGGGGWGGGGGGGGW
WGGWGGWGGWWWWGGWWWWGGWGGWWWWWWWGGWGGWWWWGGWGGWWWWWWWWWWWWWGGW
WGGGGGGGGGGGGGGGGGWGGGGGGGGWGGWGGWGGGGGWGGWGGGGGGGGGGGGGGWGGW
WGGWWWWWWWWWWGGWGGWGGWGGWWWWGGWGGWGGWWWWGGWGGWWWWGGWGGWWWWGGW
WGGWGGGGGGGGGGGWGGGGGWGGGGGWGGGGGGGGGGGWGGGGGWGGGGGWGGGGGGGGG
WWWWWWWWWWWWWWWWWWWWWWWWWWWWWWWWWWWWWWWWWWWWWWWWWWWWWWWWWWGGT
