B_______________
_XXX_XXXXXXXXXX_
_X____________X_
_X_XXXXXXXXXXXX_
X__X____________
___X_X__________
_____X_________T
