GGGWWWWWWWWWWWWWWWWWWWWWWWWWWWWWWWWWWWWWWWWWWWWWWWWWWWWWWWWWWWWWWWWWWWWWWWWWWWWWWWWWWWWWWWWWWWWWWWWWWWWWWWWWWWWWWWWWWWWWWWWWWWWWWWWWWWWWWWWWWWWWWWWWWWW
GGGGGGWGGGGGGGGGGGGGGGGGGGGGGGGGGWGGGGGGGGGGGGGGWGGGGGWGGGGGWGGGGGGGGGGGGGGWGGWGGWGGGGGGGGGGGWGGGGGWGGWGGGGGGGGGGGGGGWGGWGGGGGWGGWGGWGGGGGGGGWGGGGGWGBW
WGGWWWWGGWWWWGGWWWWWWWWWWWWWGGWWWWWWWWWWGGWWWWWWWWWWGGWWWWGGWGGWWWWWWWGGWGGWGGWGGWWWWGGWWWWGGWWWWGGWGGWGGWWWWGGWWWWGGWGGWWWWGGWGGWGGWWWWGGWWWWGGWWWWGGW
WGGGGGGGGWGGWGGWGGGGGGGGGGGWGGGGGWGGWGGWGGGGGGGGWGGGGGGGGGGGWGGGGGWGGWGGWGGWGGGGGGGGWGGGGGWGGWGGGGGWGGGGGWGGWGGGGGWGGGGGGGGWGGGGGWGGGGGWGGGGGWGGGGGWGGW
WGGWWWWWWWGGWGGWWWWWWWWWWGGWGGWGGWGGWGGWWWWGGWWWWWWWGGWGGWGGWWWWWWWGGWGGWWWWGGWWWWGGWWWWGGWWWWWWWGGWGGWGGWGGWGGWWWWWWWWWWWWWWWWGGWWWWGGWGGWGGWWWWGGWGGW
WGGGGGGGGWGGGGGWGGWGGWGGGGGGGGWGGWGGGGGGGGGGGGGGWGGWGGWGGWGGWGGWGGWGGGGGGGGWGGWGGWGGGGGGGGGGGGGGGGGGGGWGGWGGGGGGGGGGGGGGGGGGGGWGGGGGGGGGGGWGGGGGGGGGGGW
WGGWGGWWWWGGWGGWGGWGGWGGWGGWWWWWWWWWWWWWWWWGGWGGWGGWWWWGGWWWWGGWGGWWWWWWWGGWGGWGGWGGWWWWGGWWWWWWWWWWWWWWWWWWWGGWWWWGGWWWWWWWWWWGGWGGWWWWWWWGGWWWWGGWWWW
WGGWGGWGGGGGWGGGGGGGGWGGWGGWGGGGGWGGGGGWGGGGGWGGGGGGGGGGGGGGWGGGGGWGGGGGGGGGGGGGGWGGWGGWGGGGGGGGWGGGGGGGGWGGWGGGGGWGGWGGWGGGGGWGGWGGWGGGGGWGGGGGWGGGGGW
WGGWGGWWWWGGWWWWGGWWWWWWWWWWGGWWWWGGWGGWWWWGGWWWWGGWGGWWWWWWWGGWWWWWWWWWWWWWGGWWWWWWWGGWGGWWWWWWWGGWWWWWWWGGWGGWWWWWWWGGWGGWGGWGGWGGWGGWWWWGGWWWWWWWGGW
WGGWGGWGGGGGGGGWGGGGGWGGGGGGGGWGGGGGWGGGGGGGGWGGWGGWGGGGGWGGGGGGGGGGGGGGGGGGGGGGGWGGGGGGGGGGGGGGWGGGGGWGGGGGGGGGGGWGGGGGGGGWGGWGGWGGGGGWGGGGGGGGGGGWGGW
WWWWWWWWWWWWWWWWWWWGGWGGWGGWWWWGGWWWWWWWWWWGGWGGWGGWWWWGGWWWWWWWGGWWWWGGWGGWWWWWWWGGWGGWWWWWWWWWWWWWGGWWWWWWWWWWGGWGGWWWWWWWGGWWWWWWWWWWWWWWWWGGWGGWWWW
WGGGGGGGGWGGGGGGGGGGGWGGWGGGGGWGGGGGWGGWGGWGGGGGWGGWGGWGGWGGGGGWGGGGGWGGWGGWGGWGGGGGWGGWGGWGGGGGGGGGGGGGGWGGWGGGGGGGGGGGGGGWGGWGGGGGGGGGGGGGGGGGWGGGGGW
WGGWWWWWWWWWWWWWWWWGGWGGWGGWGGWGGWWWWGGWGGWWWWWWWWWWGGWWWWWWWGGWGGWGGWWWWWWWGGWWWWGGWWWWGGWGGWWWWGGWGGWWWWGGWWWWWWWGGWWWWGGWWWWWWWWWWWWWGGWWWWGGWWWWWWW
WGGGGGGGGWGGGGGGGGGGGWGGWGGWGGWGGGGGGGGGGGGGGGGGGGGWGGGGGWGGGGGGGGWGGWGGWGGGGGWGGGGGGGGGGGWGGWGGWGGWGGWGGGGGWGGGGGWGGWGGGGGGGGWGGGGGGGGWGGWGGGGGGGGGGGW
WGGWGGWGGWWWWGGWWWWGGWGGWWWWGGWGGWGGWGGWWWWGGWWWWWWWGGWWWWGGWWWWGGWWWWGGWGGWGGWGGWWWWGGWWWWWWWGGWGGWWWWWWWGGWWWWGGWGGWWWWWWWWWWWWWGGWWWWWWWGGWWWWWWWGGW
WGGWGGWGGGGGWGGGGGWGGGGGWGGGGGWGGWGGWGGWGGGGGWGGGGGWGGGGGWGGGGGWGGGGGGGGWGGWGGWGGGGGWGGGGGGGGWGGGGGGGGGGGGGGGGGWGGGGGGGGGGGWGGWGGGGGWGGWGGGGGWGGGGGWGGW
WWWWWWWWWWGGWWWWGGWWWWGGWGGWGGWWWWGGWGGWWWWWWWGGWWWWGGWWWWWWWGGWGGWWWWWWWWWWGGWWWWGGWGGWWWWWWWWWWGGWGGWWWWWWWWWWWWWGGWGGWWWWGGWGGWWWWGGWWWWGGWWWWGGWWWW
WGGGGGGGGWGGGGGWGGGGGWGGWGGWGGWGGWGGWGGWGGWGGGGGGGGGGGWGGGGGWGGWGGGGGWGGGGGWGGGGGWGGWGGGGGWGGGGGWGGWGGWGGGGGWGGWGGGGGWGGWGGWGGGGGGGGGGGGGGWGGWGGGGGWGGW
WGGWGGWGGWGGWGGWGGWWWWGGWWWWWWWGGWWWWGGWGGWWWWGGWGGWWWWWWWGGWWWWWWWGGWWWWGGWGGWWWWGGWWWWWWWGGWGGWGGWWWWWWWGGWGGWWWWGGWWWWGGWWWWWWWGGWWWWGGWGGWGGWWWWGGW
WGGWGGWGGWGGWGGGGGGGGWGGGGGWGGGGGWGGGGGGGGGGGGGGWGGGGGGGGWGGGGGGGGWGGGGGGGGGGGWGGGGGWGGGGGGGGWGGGGGWGGGGGGGGGGGGGGGGGWGGGGGGGGGGGWGGGGGWGGGGGWGGGGGGGGW
WGGWWWWWWWWWWGGWWWWWWWGGWWWWGGWGGWWWWWWWWWWGGWGGWGGWWWWWWWGGWWWWWWWWWWWWWWWWWWWGGWWWWWWWWWWGGWWWWGGWGGWWWWGGWWWWWWWGGWWWWGGWWWWWWWGGWGGWWWWGGWWWWGGWWWW
WGGGGGGGGWGGGGGGGGWGGWGGGGGGGGWGGGGGWGGGGGWGGWGGWGGGGGGGGGGGWGGWGGGGGWGGGGGGGGGGGWGGWGGGGGWGGWGGGGGGGGGGGWGGGGGGGGWGGWGGGGGGGGWGGWGGWGGWGGGGGWGGWGGWGGW
WGGWWWWWWWGGWWWWWWWGGWWWWWWWGGWWWWGGWWWWGGWGGWWWWGGWWWWGGWGGWGGWGGWGGWWWWWWWGGWWWWGGWWWWGGWGGWWWWWWWWWWGGWWWWGGWWWWGGWWWWGGWWWWGGWWWWWWWGGWGGWGGWGGWGGW
WGGGGGGGGGGGGGGWGGWGGGGGWGGGGGWGGWGGGGGGGGGGGWGGGGGGGGWGGWGGGGGWGGWGGGGGGGGGGGWGGGGGWGGGGGWGGGGGGGGGGGWGGGGGWGGGGGWGGWGGGGGWGGGGGGGGWGGGGGWGGGGGGGGGGGW
WWWWWWWWWWWWWGGWGGWGGWGGWWWWGGWGGWGGWWWWGGWWWWWWWWWWWWWWWWGGWWWWGGWGGWGGWWWWGGWGGWWWWWWWGGWWWWGGWGGWWWWGGWWWWWWWWWWWWWWWWGGWGGWWWWWWWWWWGGWWWWWWWWWWGGW
WGGWGGGGGWGGGGGGGGGGGWGGGGGWGGGGGWGGWGGGGGGGGWGGGGGWGGGGGWGGGGGGGGWGGWGGWGGWGGGGGWGGGGGGGGGGGWGGWGGGGGWGGWGGGGGGGGGGGGGGGGGGGGWGGGGGGGGGGGGGGWGGGGGGGGW
WGGWWWWGGWGGWWWWWWWGGWWWWWWWGGWGGWWWWGGWWWWGGWGGWWWWWWWGGWWWWGGWWWWGGWWWWGGWWWWWWWWWWWWWGGWWWWWWWWWWGGWGGWWWWGGWGGWGGWWWWWWWWWWWWWGGWWWWWWWWWWGGWGGWWWW
WGGWGGGGGWGGWGGGGGWGGWGGGGGWGGWGGWGGGGGWGGGGGWGGWGGGGGWGGWGGWGGGGGWGGWGGGGGGGGGGGGGGWGGGGGWGGWGGGGGGGGWGGGGGWGGWGGWGGGGGGGGGGGGGGGGGGGGGGGWGGGGGWGGWGGW
WGGWWWWGGWGGWGGWGGWGGWWWWGGWGGWWWWGGWWWWWWWWWWGGWGGWWWWGGWGGWGGWGGWGGWGGWWWWWWWGGWGGWWWWGGWGGWWWWGGWWWWGGWWWWWWWGGWGGWGGWGGWWWWWWWWWWGGWGGWWWWGGWGGWGGW
WGGGGGGGGGGGWGGWGGGGGWGGGGGWGGWGGWGGWGGWGGGGGGGGGGGWGGWGGGGGGGGWGGWGGGGGWGGWGGWGGWGGGGGGGGGGGWGGWGGWGGWGGWGGGGGWGGWGGWGGWGGGGGGGGWGGGGGWGGWGGWGGWGGGGGW
WGGWWWWWWWGGWGGWWWWGGWGGWWWWWWWGGWWWWGGWWWWGGWWWWGGWGGWWWWWWWGGWWWWWWWWWWGGWGGWWWWGGWWWWWWWGGWGGWWWWGGWWWWGGWWWWGGWWWWGGWWWWGGWWWWGGWGGWWWWGGWWWWWWWWWW
WGGGGGWGGWGGWGGWGGGGGWGGGGGGGGWGGGGGWGGWGGGGGGGGWGGWGGGGGGGGGGGWGGGGGGGGWGGGGGGGGWGGWGGWGGGGGGGGWGGWGGGGGGGGGGGGGGWGGGGGGGGWGGWGGWGGWGGWGGWGGWGGWGGWGGW
WGGWWWWGGWGGWWWWWWWWWWGGWWWWWWWGGWWWWGGWWWWGGWWWWWWWGGWWWWWWWWWWWWWGGWGGWWWWGGWWWWWWWGGWWWWWWWGGWGGWWWWGGWGGWGGWWWWWWWWWWWWWWWWGGWWWWWWWGGWGGWGGWGGWGGW
WGGGGGGGGWGGGGGWGGGGGGGGGGGGGGGGGGGGGGGGGGGGGGGGWGGGGGWGGGGGWGGGGGGGGWGGWGGWGGWGGWGGWGGGGGGGGGGGWGGGGGGGGWGGWGGWGGGGGGGGGGGWGGGGGWGGGGGWGGGGGGGGWGGGGGW
WWWWWWWGGWWWWGGWWWWWWWGGWGGWGGWWWWGGWWWWGGWWWWWWWGGWGGWGGWWWWWWWGGWWWWWWWGGWGGWGGWGGWWWWGGWWWWWWWGGWWWWGGWWWWWWWGGWWWWGGWGGWGGWWWWGGWWWWWWWGGWWWWWWWGGW
WGGWGGGGGWGGGGGGGGWGGGGGWGGWGGGGGWGGGGGWGGGGGGGGWGGWGGGGGWGGWGGGGGGGGGGGWGGWGGWGGGGGGGGGGGGGGGGGWGGWGGGGGGGGWGGWGGWGGGGGWGGWGGWGGGGGWGGGGGWGGGGGWGGGGGW
WGGWWWWGGWGGWWWWGGWGGWGGWWWWWWWWWWWWWGGWWWWGGWGGWWWWGGWWWWGGWWWWWWWWWWGGWGGWGGWWWWGGWWWWWWWWWWWWWGGWWWWWWWGGWGGWWWWGGWWWWGGWGGWGGWWWWWWWGGWWWWGGWWWWGGW
WGGGGGGGGWGGWGGGGGGGGWGGWGGGGGGGGGGGGGGGGGWGGWGGWGGGGGGGGGGGWGGGGGGGGWGGGGGGGGGGGWGGWGGGGGWGGGGGGGGWGGGGGGGGWGGGGGGGGWGGWGGGGGGGGGGGWGGGGGGGGGGGGGGGGGW
WGGWGGWWWWWWWGGWWWWGGWWWWGGWWWWWWWWWWWWWWWWGGWWWWWWWGGWWWWGGWWWWGGWWWWGGWWWWGGWWWWWWWGGWGGWGGWGGWWWWWWWWWWGGWGGWGGWGGWGGWGGWWWWGGWWWWGGWWWWWWWWWWWWWGGW
WGGWGGWGGGGGGGGWGGWGGWGGGGGWGGGGGGGGWGGWGGGGGWGGGGGGGGGGGWGGGGGGGGGGGWGGGGGWGGWGGGGGWGGWGGGGGWGGGGGGGGGGGWGGGGGWGGWGGGGGWGGWGGGGGWGGGGGGGGGGGGGGWGGWGGW
WGGWGGWWWWGGWGGWGGWGGWWWWWWWGGWWWWGGWGGWWWWWWWWWWGGWGGWGGWWWWWWWGGWWWWGGWGGWGGWWWWGGWWWWGGWGGWWWWWWWGGWWWWWWWGGWWWWWWWGGWWWWGGWWWWGGWWWWWWWGGWWWWGGWGGW
WGGWGGGGGWGGWGGGGGWGGWGGGGGGGGGGGWGGGGGGGGGGGWGGGGGWGGWGGGGGWGGWGGGGGGGGWGGWGGGGGGGGGGGWGGWGGGGGWGGWGGWGGWGGWGGGGGWGGGGGGGGWGGWGGGGGGGGGGGWGGWGGGGGWGGW
WWWWWWWGGWWWWWWWGGWWWWWWWWWWWWWWWWWWWGGWWWWGGWWWWWWWGGWWWWGGWGGWWWWWWWWWWWWWGGWGGWWWWGGWWWWWWWWWWGGWWWWGGWGGWGGWWWWWWWWWWWWWWWWWWWGGWWWWWWWGGWWWWGGWGGW
WGGGGGWGGGGGGGGWGGWGGGGGGGGGGGWGGGGGWGGGGGWGGWGGWGGGGGWGGGGGWGGGGGGGGGGGWGGGGGWGGWGGWGGGGGGGGGGGWGGWGGGGGGGGWGGWGGWGGWGGWGGWGGWGGWGGWGGGGGGGGWGGGGGGGGW
WWWWGGWGGWWWWWWWGGWWWWWWWGGWGGWGGWWWWWWWWWWGGWGGWWWWWWWWWWGGWWWWWWWWWWGGWWWWGGWWWWGGWWWWWWWWWWWWWGGWWWWGGWGGWGGWGGWGGWGGWGGWGGWGGWWWWWWWWWWWWWGGWWWWGGW
WGGWGGGGGGGGGGGWGGWGGWGGGGGWGGGGGWGGGGGWGGGGGGGGWGGGGGGGGWGGWGGGGGGGGWGGWGGGGGGGGGGGGGGWGGWGGWGGWGGGGGWGGWGGGGGGGGWGGGGGGGGGGGWGGWGGGGGWGGGGGWGGWGGGGGW
WGGWWWWGGWWWWGGWWWWGGWWWWGGWWWWWWWGGWGGWWWWGGWWWWGGWWWWWWWWWWGGWWWWWWWGGWGGWWWWGGWGGWWWWGGWGGWGGWWWWGGWWWWWWWGGWGGWWWWGGWWWWGGWGGWGGWWWWGGWGGWWWWWWWGGW
WGGGGGGGGWGGWGGWGGGGGGGGGGGGGGWGGGGGWGGWGGGGGGGGGGGWGGWGGGGGWGGGGGGGGWGGGGGGGGWGGWGGGGGWGGWGGGGGWGGGGGWGGGGGGGGWGGWGGGGGGGGWGGGGGWGGGGGGGGWGGGGGGGGGGGW
WWWWWWWWWWGGWWWWWWWGGWGGWWWWWWWGGWGGWWWWGGWWWWGGWWWWGGWGGWWWWWWWGGWGGWGGWWWWWWWWWWGGWGGWGGWGGWWWWGGWWWWGGWWWWWWWGGWGGWGGWWWWWWWGGWWWWGGWWWWGGWGGWWWWGGW
WGGGGGGGGGGGGGGGGGWGGWGGGGGWGGGGGWGGWGGWGGGGGWGGWGGGGGGGGGGGWGGGGGWGGGGGWGGGGGGGGWGGWGGWGGGGGGGGGGGWGGWGGWGGWGGGGGGGGWGGGGGGGGWGGGGGWGGWGGWGGWGGGGGWGGW
WGGWGGWGGWGGWWWWGGWGGWWWWWWWWWWGGWWWWGGWGGWWWWWWWGGWGGWWWWGGWWWWWWWWWWGGWWWWWWWGGWGGWWWWGGWWWWWWWGGWGGWGGWGGWWWWWWWGGWWWWGGWWWWGGWGGWGGWGGWWWWGGWGGWWWW
WGGWGGWGGWGGGGGWGGGGGGGGWGGWGGWGGGGGGGGWGGGGGWGGGGGWGGGGGWGGWGGWGGGGGGGGGGGWGGWGGGGGGGGGGGGGGWGGGGGGGGWGGGGGGGGGGGWGGWGGGGGWGGGGGWGGWGGGGGWGGWGGWGGGGGW
WWWWWWWWWWWWWWWWGGWGGWWWWGGWGGWGGWWWWWWWGGWGGWWWWWWWGGWWWWGGWGGWWWWGGWWWWWWWGGWGGWWWWGGWGGWGGWWWWGGWWWWWWWWWWGGWGGWWWWGGWWWWWWWWWWGGWGGWWWWGGWWWWWWWGGW
WGGGGGGGGGGGWGGGGGWGGGGGWGGWGGGGGGGGWGGGGGWGGWGGGGGGGGWGGGGGWGGGGGWGGWGGGGGGGGGGGWGGGGGWGGWGGGGGWGGWGGGGGWGGGGGWGGGGGWGGGGGGGGWGGGGGGGGWGGWGGGGGWGGGGGW
WGGWGGWGGWWWWGGWWWWWWWWWWGGWWWWGGWGGWWWWGGWGGWWWWGGWWWWWWWGGWGGWGGWWWWGGWWWWWWWGGWGGWWWWWWWGGWWWWGGWGGWWWWWWWWWWWWWGGWWWWGGWWWWWWWWWWGGWGGWGGWWWWWWWWWW
WGGWGGWGGGGGWGGGGGGGGGGGWGGGGGGGGWGGWGGGGGWGGWGGWGGWGGGGGGGGWGGWGGWGGGGGGGGWGGGGGWGGWGGGGGGGGWGGWGGWGGWGGWGGWGGGGGGGGWGGGGGGGGGGGWGGWGGWGGGGGWGGGGGGGGW
WWWWGGWGGWWWWGGWWWWGGWGGWGGWWWWGGWGGWGGWWWWWWWGGWGGWGGWGGWGGWGGWWWWGGWGGWWWWWWWGGWWWWWWWWWWWWWGGWGGWGGWGGWGGWWWWGGWWWWGGWWWWWWWWWWGGWGGWGGWGGWWWWWWWGGW
WGGWGGWGGWGGWGGWGGGGGWGGWGGGGGWGGWGGGGGWGGWGGGGGGGGWGGWGGWGGGGGGGGWGGWGGWGGWGGWGGGGGGGGWGGWGGGGGGGGWGGGGGGGGGGGWGGGGGWGGGGGWGGGGGWGGGGGWGGWGGGGGWGGWGGW
WGGWGGWGGWGGWWWWGGWWWWGGWGGWWWWWWWGGWWWWGGWGGWWWWWWWGGWWWWWWWGGWWWWWWWGGWGGWGGWWWWWWWGGWGGWWWWWWWWWWWWWGGWGGWGGWWWWWWWGGWGGWWWWGGWGGWWWWWWWGGWWWWGGWGGW
WGGGGGWGGGGGGGGGGGGGGWGGGGGWGGGGGGGGWGGWGGGGGWGGGGGWGGWGGWGGWGGGGGGGGGGGWGGWGGGGGWGGWGGGGGGGGGGGGGGWGGGGGWGGWGGGGGGGGGGGWGGGGGWGGGGGGGGGGGWGGGGGGGGWGGW
WWWWGGWWWWWWWGGWGGWWWWWWWWWWGGWWWWWWWGGWWWWGGWWWWGGWWWWGGWGGWGGWWWWWWWGGWGGWGGWWWWGGWWWWWWWGGWWWWGGWGGWWWWGGWGGWGGWWWWWWWGGWWWWWWWGGWWWWGGWGGWWWWGGWGGW
WGGGGGWGGWGGWGGWGGGGGGGGWGGGGGGGGWGGGGGGGGWGGGGGGGGWGGWGGGGGWGGGGGGGGWGGGGGGGGGGGGGGGGGGGGWGGWGGGGGWGGGGGWGGWGGWGGGGGGGGWGGWGGGGGGGGGGGWGGGGGGGGWGGGGGW
WWWWWWWGGWGGWGGWWWWGGWWWWGGWWWWGGWGGWGGWWWWWWWWWWGGWGGWWWWGGWGGWGGWWWWGGWGGWWWWWWWGGWWWWGGWWWWGGWWWWWWWWWWWWWGGWGGWWWWGGWWWWGGWWWWGGWWWWWWWWWWWWWWWWGGW
WGGWGGGGGGGGWGGWGGGGGGGGWGGWGGWGGWGGWGGGGGWGGGGGWGGGGGWGGWGGGGGWGGWGGGGGWGGGGGWGGWGGGGGWGGWGGGGGGGGWGGWGGWGGWGGWGGWGGWGGWGGGGGWGGGGGGGGWGGGGGWGGWGGGGGW
WGGWWWWGGWGGWGGWWWWGGWGGWWWWGGWWWWWWWGGWGGWGGWWWWGGWGGWGGWGGWWWWWWWWWWWWWGGWGGWGGWGGWWWWWWWGGWGGWGGWGGWGGWGGWGGWWWWGGWWWWWWWGGWGGWWWWWWWWWWGGWGGWWWWGGW
WGGGGGGGGWGGWGGWGGGGGWGGGGGWGGWGGGGGGGGWGGWGGGGGGGGWGGGGGWGGWGGWGGGGGWGGGGGWGGWGGGGGWGGGGGWGGWGGWGGGGGGGGGGGGGGGGGGGGWGGWGGGGGWGGGGGGGGWGGGGGWGGGGGWGGW
WWWWWWWGGWWWWWWWGGWWWWGGWWWWGGWGGWWWWWWWGGWGGWGGWWWWGGWWWWWWWGGWGGWGGWGGWWWWGGWWWWWWWWWWGGWGGWWWWGGWWWWWWWGGWGGWGGWGGWGGWWWWWWWGGWWWWGGWGGWWWWWWWGGWWWW
WGGGGGWGGGGGGGGWGGWGGWGGWGGWGGGGGGGGGGGWGGWGGWGGWGGGGGGGGWGGWGGWGGWGGWGGGGGWGGGGGGGGGGGWGGGGGWGGGGGWGGWGGGGGWGGWGGWGGWGGWGGGGGGGGGGGWGGGGGWGGGGGGGGGGGW
WGGWWWWGGWWWWGGWGGWGGWGGWGGWGGWGGWWWWWWWGGWWWWGGWWWWWWWWWWGGWGGWGGWWWWGGWGGWWWWWWWGGWGGWWWWWWWWWWWWWGGWGGWWWWWWWGGWGGWGGWWWWWWWGGWWWWWWWGGWGGWWWWGGWWWW
WGGGGGWGGGGGWGGGGGWGGWGGGGGWGGWGGGGGGGGWGGGGGWGGGGGGGGGGGWGGGGGWGGWGGWGGWGGGGGGGGWGGWGGWGGGGGGGGGGGGGGWGGWGGGGGGGGWGGGGGWGGWGGGGGWGGGGGGGGGGGGGGWGGGGGW
WWWWGGWGGWWWWGGWWWWGGWGGWWWWGGWGGWGGWWWWGGWWWWGGWGGWWWWGGWGGWWWWGGWGGWWWWWWWGGWWWWGGWWWWWWWWWWWWWGGWGGWWWWWWWWWWGGWGGWGGWGGWGGWGGWWWWGGWWWWWWWWWWWWWGGW
WGGWGGGGGWGGWGGGGGWGGWGGGGGWGGWGGWGGWGGGGGWGGGGGWGGWGGWGGGGGWGGGGGGGGGGGGGGGGGGGGWGGGGGGGGWGGGGGGGGWGGWGGWGGWGGGGGWGGWGGWGGGGGWGGGGGWGGGGGWGGGGGWGGGGGW
WGGWWWWWWWGGWWWWGGWGGWWWWWWWWWWWWWWWWWWWGGWWWWWWWGGWGGWGGWWWWWWWWWWWWWWWWWWWWWWWWWGGWWWWGGWWWWWWWGGWWWWGGWGGWWWWGGWWWWGGWWWWWWWGGWGGWWWWGGWGGWGGWGGWWWW
WGGGGGGGGGGGGGGGGGGGGWGGGGGWGGGGGGGGWGGGGGGGGGGGWGGWGGGGGWGGGGGWGGWGGWGGWGGGGGGGGWGGGGGWGGGGGGGGGGGGGGWGGGGGWGGWGGWGGGGGWGGGGGGGGWGGWGGWGGGGGWGGWGGGGGW
WGGWWWWWWWGGWWWWGGWGGWGGWWWWWWWWWWGGWGGWGGWGGWGGWWWWGGWWWWGGWGGWGGWGGWGGWWWWWWWGGWWWWWWWGGWWWWWWWWWWWWWWWWGGWGGWGGWGGWWWWGGWWWWWWWGGWGGWGGWGGWWWWWWWWWW
WGGWGGGGGWGGGGGWGGWGGGGGGGGWGGGGGWGGWGGWGGWGGWGGGGGGGGGGGGGGWGGWGGWGGGGGWGGGGGWGGWGGGGGGGGWGGGGGWGGWGGGGGGGGGGGGGGWGGWGGGGGWGGGGGGGGWGGWGGWGGGGGWGGGGGW
WWWWWWWGGWGGWWWWGGWWWWWWWGGWWWWGGWGGWGGWWWWWWWGGWWWWGGWGGWWWWWWWGGWWWWGGWWWWGGWGGWGGWWWWWWWGGWWWWGGWWWWGGWWWWWWWWWWWWWWWWWWWWWWGGWWWWGGWGGWWWWGGWGGWGGW
WGGGGGGGGGGGWGGGGGGGGWGGWGGGGGGGGGGGWGGGGGWGGWGGWGGGGGWGGWGGGGGGGGWGGGGGWGGWGGGGGGGGGGGWGGGGGGGGWGGGGGWGGWGGWGGWGGGGGWGGGGGWGGWGGWGGGGGGGGWGGGGGGGGWGGW
WWWWGGWWWWWWWGGWWWWGGWGGWWWWWWWWWWGGWGGWWWWGGWWWWGGWWWWWWWWWWWWWGGWWWWGGWGGWWWWWWWGGWWWWWWWWWWGGWWWWGGWGGWGGWGGWGGWWWWWWWGGWGGWWWWGGWGGWWWWWWWWWWWWWGGW
WGGGGGWGGWGGGGGWGGGGGWGGWGGGGGWGGGGGWGGGGGGGGWGGGGGGGGGGGWGGWGGGGGGGGWGGGGGWGGGGGWGGGGGWGGGGGGGGGGGGGGGGGGGGGGGWGGWGGGGGWGGWGGGGGWGGWGGGGGGGGGGGWGGGGGW
WWWWGGWGGWWWWGGWWWWWWWGGWGGWGGWGGWGGWGGWWWWGGWWWWWWWGGWWWWGGWGGWWWWGGWGGWWWWWWWGGWGGWWWWWWWWWWWWWWWWGGWWWWWWWGGWGGWGGWWWWGGWGGWWWWWWWGGWWWWWWWWWWGGWGGW
WGGGGGGGGWGGGGGGGGGGGGGGWGGWGGGGGWGGWGGWGGWGGWGGGGGWGGGGGGGGWGGGGGWGGWGGGGGGGGWGGGGGWGGGGGGGGGGGWGGGGGWGGGGGGGGGGGGGGWGGGGGGGGWGGGGGWGGGGGWGGGGGWGGWGGW
WGGWGGWWWWWWWGGWGGWGGWWWWWWWWWWGGWWWWGGWGGWWWWGGWWWWWWWWWWWWWGGWGGWWWWWWWGGWGGWWWWGGWGGWWWWGGWWWWWWWGGWWWWWWWGGWGGWWWWWWWGGWWWWWWWGGWWWWWWWWWWGGWWWWWWW
WGGWGGGGGWGGWGGWGGWGGGGGGGGWGGGGGGGGGGGWGGWGGWGGWGGWGGWGGGGGWGGWGGGGGWGGGGGWGGGGGWGGWGGWGGWGGWGGWGGGGGGGGWGGGGGWGGWGGWGGWGGGGGGGGWGGWGGWGGGGGGGGGGGGGGW
WGGWGGWWWWGGWWWWWWWGGWGGWWWWWWWWWWWWWGGWGGWGGWGGWGGWGGWWWWGGWGGWGGWGGWWWWWWWGGWGGWWWWGGWGGWWWWGGWWWWWWWWWWWWWWWWGGWGGWGGWWWWGGWGGWGGWGGWWWWWWWGGWGGWWWW
WGGWGGWGGWGGGGGGGGGGGWGGWGGGGGWGGGGGGGGGGGGGGWGGGGGWGGGGGGGGGGGWGGWGGWGGWGGGGGWGGWGGGGGGGGGGGGGGWGGGGGGGGGGGGGGGGGWGGGGGGGGGGGWGGWGGWGGWGGWGGGGGWGGWGGW
WGGWWWWGGWGGWWWWWWWGGWWWWGGWWWWWWWGGWWWWGGWGGWWWWGGWWWWGGWWWWGGWWWWWWWGGWGGWGGWWWWGGWWWWGGWWWWWWWGGWWWWGGWWWWGGWWWWGGWWWWGGWWWWGGWGGWGGWGGWWWWGGWWWWGGW
WGGWGGGGGWGGWGGWGGWGGGGGWGGGGGWGGGGGWGGGGGWGGGGGWGGGGGGGGWGGGGGGGGGGGGGGGGGWGGWGGWGGGGGWGGWGGGGGGGGWGGGGGGGGWGGWGGWGGGGGWGGWGGWGGGGGGGGWGGGGGGGGGGGGGGW
WGGWWWWGGWWWWGGWGGWGGWGGWGGWWWWWWWGGWWWWWWWGGWWWWWWWGGWGGWWWWGGWGGWWWWGGWWWWGGWGGWGGWWWWWWWWWWWWWGGWWWWGGWGGWGGWGGWWWWWWWWWWGGWGGWWWWGGWWWWWWWWWWWWWGGW
WGGGGGGGGWGGGGGWGGWGGWGGWGGGGGWGGGGGGGGWGGGGGGGGGGGWGGWGGWGGWGGWGGWGGWGGGGGWGGGGGGGGWGGWGGWGGGGGWGGGGGWGGWGGWGGGGGWGGWGGWGGWGGWGGGGGWGGGGGGGGWGGGGGGGGW
WWWWWWWWWWWWWGGWGGWGGWGGWGGWWWWWWWGGWGGWWWWGGWWWWWWWWWWWWWGGWGGWWWWGGWGGWWWWGGWGGWWWWGGWGGWGGWGGWWWWGGWGGWWWWWWWWWWGGWGGWGGWGGWWWWWWWGGWGGWGGWGGWWWWGGW
WGGGGGGGGWGGGGGGGGWGGWGGGGGGGGGGGWGGWGGWGGGGGGGGWGGGGGGGGGGGGGGWGGGGGGGGWGGWGGWGGWGGWGGGGGGGGWGGWGGGGGWGGWGGGGGGGGGGGGGGWGGGGGGGGGGGGGGWGGWGGGGGGGGWGGW
WGGWWWWGGWGGWGGWGGWGGWGGWWWWGGWGGWWWWWWWGGWWWWGGWWWWGGWGGWGGWWWWWWWWWWWWWGGWWWWGGWGGWGGWWWWWWWWWWGGWGGWWWWWWWGGWGGWWWWWWWWWWGGWWWWGGWWWWWWWWWWGGWWWWGGW
WGGWGGWGGGGGWGGWGGGGGWGGGGGWGGWGGWGGGGGWGGWGGWGGGGGWGGWGGWGGWGGGGGGGGWGGWGGGGGWGGWGGGGGGGGGGGGGGGGGWGGGGGGGGGGGWGGGGGGGGWGGWGGWGGWGGGGGGGGWGGGGGWGGGGGW
WWWWGGWGGWWWWWWWGGWGGWWWWGGWGGWGGWGGWGGWGGWGGWWWWWWWWWWWWWWWWWWWWWWGGWGGWGGWGGWGGWWWWGGWWWWGGWGGWGGWWWWGGWWWWWWWWWWWWWGGWGGWWWWGGWWWWGGWWWWGGWGGWGGWGGW
WGGWGGGGGGGGWGGGGGWGGWGGGGGWGGWGGGGGWGGWGGGGGWGGGGGWGGGGGGGGGGGWGGGGGGGGGGGWGGWGGGGGGGGGGGWGGWGGWGGGGGWGGGGGGGGWGGWGGGGGWGGGGGWGGGGGGGGGGGWGGWGGWGGWGGW
WGGWGGWWWWWWWWWWWWWGGWWWWGGWWWWWWWWWWWWWGGWWWWGGWGGWGGWWWWWWWGGWWWWWWWGGWGGWGGWWWWWWWWWWGGWWWWWWWWWWWWWGGWGGWWWWGGWWWWGGWWWWGGWGGWWWWGGWWWWGGWWWWGGWWWW
WGGGGGGGGGGGWGGGGGWGGGGGWGGGGGGGGGGGGGGWGGWGGGGGWGGGGGGGGGGGWGGGGGWGGWGGWGGWGGWGGGGGWGGGGGWGGWGGWGGGGGWGGWGGWGGWGGWGGGGGGGGGGGWGGWGGWGGWGGWGGWGGGGGWGGW
WGGWWWWWWWGGWWWWGGWGGWGGWGGWWWWGGWGGWWWWGGWGGWWWWGGWWWWGGWWWWGGWGGWGGWGGWGGWWWWWWWGGWGGWGGWGGWGGWGGWWWWWWWGGWGGWGGWWWWWWWWWWGGWWWWGGWGGWGGWWWWWWWGGWGGW
WTGGGGWGGGGGWGGGGGGGGWGGWGGGGGWGGWGGWGGGGGGGGWGGGGGGGGWGGWGGGGGWGGWGGGGGWGGGGGGGGGGGGGGWGGGGGGGGGGGGGGGGGWGGGGGGGGWGGGGGGGGGGGGGGGGGGGGWGGGGGGGGGGGGGGG
WWWWWWWWWWWWWWWWWWWWWWWWWWWWWWWWWWWWWWWWWWWWWWWWWWWWWWWWWWWWWWWWWWWWWWWWWWWWWWWWWWWWWWWWWWWWWWWWWWWWWWWWWWWWWWWWWWWWWWWWWWWWWWWWWWWWWWWWWWWWWWWWWWWWGGG
