B__XXXXXXXXXXXXXXXXXXXXXXXXXXXXXXXXXXXXXXXXXXXXXXXXXXXXXXXXXX
___X______________X_____X_____X______________X__X__X__X_____X
X__X__XXXXXXXXXX__X__X__X__X__XXXX__XXXXXXX__X__X__X__X__XXXX
X_____X___________X__X_____X__X_____X_____X__X__X__X________X
XXXXXXXXXXXXXXXX__X__X__XXXXXXXXXX__XXXX__XXXX__X__X__XXXX__X
X____________________X_____X__X__X_______________________X__X
X__XXXX__X__XXXX__XXXX__X__X__X__X__X__XXXXXXXXXXXXXXXXXXX__X
X_____X__X__X__X_____X__X___________X_____X________X________X
X__X__XXXX__X__XXXX__XXXXXXXXXX__XXXXXXXXXX__XXXXXXXXXX__XXXX
X__X_____X_____X__X__X__X__X__X________X__X_____X__X________X
XXXXXXXXXXXXXXXX__X__X__X__X__XXXXXXX__X__X__XXXX__X__X__X__X
X________X________X__X___________X________X__X_____X__X__X__X
X__XXXXXXX__X__XXXX__X__XXXX__XXXX__X__X__X__XXXX__XXXXXXX__X
X_____X__X__X__X_____X__X__X_____X__X__X________X___________X
X__XXXX__XXXX__XXXXXXX__X__X__X__X__X__XXXX__XXXXXXXXXXXXXXXX
X__X__X_____X__X_____X_____X__X__X__X__X__X________X________X
X__X__X__XXXX__XXXX__X__XXXXXXX__X__XXXX__X__XXXXXXXXXXXXX__X
X_________________X________X__X__X_____X__X______________X__X
X__XXXXXXXXXX__X__X__X__XXXX__X__X__XXXX__X__XXXX__X__XXXX__X
X__X___________X_____X_____X___________X_____X_____X_________
XXXXXXXXXXXXXXXXXXXXXXXXXXXXXXXXXXXXXXXXXXXXXXXXXXXXXXXXXX__T
