GGGWWWWWWWWWWWWWWWWWWWWWWWWWWWWWWWWWWWWWWWWWWWWWWWWWWWWWWWWWWWWWWWWWWWWWWWWWWWWWWWWWWWWWWWWWWWWWWWWWWWWWWWWWWWWWWWWWWWWWW
GBGGGGWGGGGGGGGGGGWGGGGGGGGGGGWGGGGGGGGGGGWGGGGGGGGGGGGGGWGGGGGGGGWGGWGGWGGGGGGGGGGGGGGWGGGGGGGGGGGWGGGGGWGGGGGWGGGGGGGGW
WGGWGGWGGWGGWWWWGGWGGWWWWGGWWWWWWWGGWGGWWWWGGWWWWGGWGGWWWWWWWWWWGGWGGWGGWWWWGGWGGWWWWWWWWWWGGWWWWWWWGGWWWWGGWWWWGGWWWWWWW
WGGWGGGGGWGGGGGWGGWGGGGGWGGWGGGGGWGGWGGWGGWGGWGGGGGWGGGGGGGGGGGWGGWGGGGGGGGGGGWGGGGGGGGWGGGGGGGGWGGGGGGGGGGGGGGWGGWGGGGGW
WWWWWWWWWWGGWGGWWWWGGWWWWWWWGGWGGWWWWGGWGGWWWWWWWWWWWWWWWWWWWGGWGGWWWWGGWWWWGGWWWWGGWGGWGGWWWWWWWGGWWWWGGWGGWWWWGGWGGWGGW
WGGGGGGGGWGGWGGWGGGGGGGGWGGGGGWGGWGGWGGGGGWGGGGGGGGGGGGGGWGGWGGGGGGGGGGGWGGGGGWGGGGGWGGWGGGGGGGGWGGWGGGGGWGGWGGWGGGGGWGGW
WGGWWWWWWWGGWWWWWWWGGWWWWWWWGGWWWWGGWWWWGGWWWWGGWGGWGGWWWWGGWWWWGGWGGWGGWWWWWWWWWWWWWWWWGGWGGWWWWWWWGGWWWWWWWGGWWWWGGWWWW
WGGWGGGGGGGGWGGGGGGGGGGGWGGGGGGGGWGGWGGGGGWGGGGGWGGWGGGGGGGGGGGWGGWGGWGGWGGGGGWGGGGGGGGGGGWGGWGGWGGGGGGGGGGGGGGWGGWGGWGGW
WGGWGGWGGWGGWGGWWWWWWWGGWGGWWWWWWWGGWWWWGGWWWWGGWWWWGGWGGWGGWWWWGGWWWWGGWGGWWWWWWWGGWGGWWWWGGWGGWGGWWWWWWWWWWWWWGGWGGWGGW
WGGWGGWGGWGGGGGGGGGGGWGGGGGGGGGGGWGGWGGWGGGGGWGGGGGWGGWGGWGGWGGGGGGGGWGGGGGWGGGGGWGGWGGGGGWGGWGGWGGWGGGGGGGGWGGGGGGGGWGGW
WGGWWWWWWWWWWWWWGGWWWWWWWWWWGGWWWWGGWGGWGGWWWWWWWWWWWWWGGWGGWGGWWWWGGWGGWGGWGGWWWWWWWWWWWWWGGWGGWGGWWWWGGWWWWWWWGGWGGWGGW
WGGGGGWGGGGGWGGWGGWGGGGGWGGGGGWGGGGGGGGWGGWGGWGGWGGWGGWGGWGGGGGGGGWGGWGGWGGGGGWGGGGGWGGGGGGGGGGGGGGGGGGGGGGGGGGGGGWGGGGGW
WGGWWWWWWWGGWGGWGGWGGWGGWGGWGGWGGWWWWWWWGGWGGWGGWGGWGGWWWWGGWWWWGGWGGWGGWGGWGGWWWWGGWWWWGGWWWWWWWWWWGGWWWWWWWGGWWWWWWWWWW
WGGGGGWGGWGGGGGWGGWGGWGGGGGWGGGGGWGGGGGGGGWGGGGGWGGWGGWGGWGGWGGWGGWGGWGGWGGWGGWGGGGGWGGGGGGGGWGGGGGWGGWGGGGGGGGWGGGGGGGGW
WGGWWWWGGWWWWGGWWWWWWWWWWWWWGGWWWWWWWGGWWWWGGWWWWGGWGGWGGWWWWGGWWWWGGWGGWWWWWWWGGWGGWWWWGGWGGWGGWWWWGGWGGWWWWWWWWWWGGWWWW
WGGGGGGGGWGGGGGWGGGGGWGGGGGGGGGGGWGGWGGGGGGGGGGGWGGGGGGGGWGGGGGGGGWGGWGGGGGWGGGGGWGGWGGWGGWGGGGGWGGWGGWGGGGGGGGGGGWGGWGGW
WWWWWWWGGWGGWGGWWWWGGWWWWGGWWWWWWWGGWWWWWWWGGWWWWWWWWWWGGWGGWGGWWWWWWWGGWGGWWWWWWWGGWGGWGGWGGWGGWGGWWWWWWWWWWGGWWWWGGWGGW
WGGWGGGGGGGGWGGGGGGGGWGGGGGGGGGGGGGGGGGWGGGGGGGGGGGGGGGGGWGGWGGGGGWGGWGGWGGGGGGGGGGGGGGGGGWGGWGGGGGWGGWGGWGGWGGGGGGGGGGGW
WGGWGGWGGWWWWWWWWWWGGWWWWWWWWWWGGWWWWWWWGGWWWWGGWWWWGGWWWWGGWGGWGGWGGWWWWWWWGGWGGWWWWWWWWWWGGWGGWWWWGGWGGWGGWGGWGGWGGWWWW
WGGGGGWGGWGGWGGWGGGGGGGGGGGWGGWGGWGGGGGGGGGGGWGGGGGWGGGGGWGGWGGWGGGGGWGGGGGGGGWGGGGGGGGWGGWGGWGGWGGWGGWGGGGGGGGWGGWGGGGGW
WGGWWWWWWWGGWGGWGGWWWWWWWGGWGGWGGWGGWWWWWWWGGWWWWGGWGGWWWWWWWWWWGGWGGWGGWWWWWWWWWWGGWWWWGGWWWWWWWGGWGGWWWWGGWWWWGGWWWWWWW
WGGGGGWGGWGGGGGWGGGGGWGGGGGGGGWGGGGGGGGWGGGGGWGGGGGWGGGGGWGGGGGGGGWGGGGGGGGWGGGGGGGGWGGWGGWGGGGGWGGGGGGGGGGGGGGWGGWGGGGGW
WWWWGGWGGWGGWWWWWWWWWWWWWGGWWWWGGWWWWWWWGGWWWWWWWGGWWWWGGWWWWWWWGGWGGWGGWWWWGGWGGWGGWGGWGGWGGWWWWGGWWWWWWWWWWWWWWWWWWWGGW
WGGGGGGGGGGGGGGGGGGGGGGGWGGWGGGGGGGGWGGWGGWGGGGGWGGGGGWGGWGGWGGGGGWGGWGGWGGGGGWGGWGGWGGWGGGGGGGGWGGWGGGGGGGGGGGWGGGGGWGGW
WGGWWWWWWWWWWGGWGGWWWWGGWWWWWWWWWWWWWGGWGGWWWWGGWWWWWWWWWWGGWWWWWWWWWWGGWWWWGGWWWWGGWGGWGGWGGWWWWGGWGGWWWWWWWGGWWWWGGWGGW
WGGWGGGGGWGGGGGWGGWGGGGGWGGGGGGGGGGGGGGGGGGGGGGGWGGGGGWGGGGGGGGGGGWGGGGGWGGGGGWGGGGGWGGGGGWGGWGGGGGWGGWGGGGGWGGWGGWGGGGGW
WWWWGGWGGWWWWWWWWWWGGWWWWGGWWWWWWWWWWWWWGGWWWWWWWWWWGGWWWWGGWWWWGGWWWWGGWWWWGGWWWWWWWWWWGGWWWWWWWWWWWWWWWWGGWGGWGGWWWWGGW
WGGGGGWGGWGGGGGWGGWGGWGGGGGWGGWGGGGGGGGGGGWGGGGGWGGGGGGGGWGGGGGWGGGGGGGGGGGWGGGGGGGGGGGGGGGGGWGGWGGGGGGGGGGGGGGWGGGGGGGGW
WGGWWWWWWWWWWGGWGGWGGWGGWWWWGGWWWWWWWGGWWWWGGWGGWWWWGGWGGWWWWWWWWWWGGWWWWGGWWWWWWWGGWGGWWWWGGWGGWWWWWWWWWWWWWGGWGGWGGWWWW
WGGGGGWGGWGGWGGGGGGGGGGGWGGGGGWGGGGGGGGGGGWGGWGGWGGWGGWGGGGGGGGGGGWGGWGGGGGWGGGGGWGGWGGWGGGGGWGGWGGWGGGGGGGGGGGGGGWGGWGGW
WWWWGGWGGWGGWGGWWWWWWWGGWWWWGGWWWWWWWWWWWWWWWWGGWGGWGGWWWWWWWWWWGGWGGWWWWGGWGGWWWWGGWWWWWWWGGWGGWGGWGGWWWWGGWGGWWWWWWWGGW
WGGGGGWGGGGGWGGGGGWGGGGGWGGGGGGGGGGGGGGWGGGGGWGGGGGWGGWGGGGGWGGWGGWGGGGGWGGWGGGGGWGGGGGWGGWGGGGGWGGGGGGGGWGGWGGGGGGGGGGGW
WGGWGGWGGWGGWGGWWWWWWWGGWGGWWWWWWWGGWGGWWWWGGWGGWWWWGGWWWWGGWGGWWWWWWWWWWGGWWWWGGWGGWGGWGGWGGWGGWWWWGGWGGWWWWWWWGGWWWWGGW
WGGWGGGGGWGGGGGWGGWGGGGGWGGGGGWGGGGGWGGGGGWGGGGGGGGGGGGGGWGGGGGGGGGGGWGGGGGWGGGGGGGGWGGGGGWGGWGGGGGWGGWGGGGGWGGGGGWGGGGGW
WGGWWWWWWWWWWGGWGGWWWWGGWWWWWWWWWWGGWGGWGGWWWWGGWGGWGGWGGWGGWGGWGGWWWWGGWGGWWWWWWWWWWGGWWWWWWWWWWWWWGGWGGWGGWGGWWWWWWWGGW
WGGGGGWGGGGGGGGWGGGGGGGGWGGGGGGGGGGGWGGWGGGGGGGGWGGWGGWGGGGGWGGWGGGGGWGGWGGGGGGGGGGGWGGGGGWGGGGGWGGGGGWGGWGGWGGGGGWGGGGGW
WGGWWWWWWWWWWWWWGGWGGWWWWWWWWWWGGWGGWWWWWWWGGWWWWGGWWWWWWWWWWGGWWWWGGWWWWGGWWWWWWWWWWWWWWWWGGWWWWGGWWWWGGWGGWWWWWWWWWWGGW
WGGWGGGGGGGGWGGWGGWGGWGGGGGWGGGGGWGGGGGWGGGGGWGGWGGGGGGGGWGGGGGGGGWGGWGGGGGWGGGGGWGGGGGGGGWGGWGGWGGWGGWGGWGGGGGGGGWGGGGGW
WGGWWWWWWWGGWGGWWWWGGWWWWGGWGGWWWWGGWWWWWWWWWWGGWWWWGGWWWWWWWWWWWWWGGWGGWGGWWWWGGWGGWWWWGGWGGWGGWGGWGGWWWWWWWWWWWWWWWWWWW
WGGGGGWGGGGGGGGGGGGGGGGGGGGGGGWGGWGGWGGGGGWGGWGGGGGGGGGGGWGGGGGWGGGGGWGGWGGGGGGGGWGGWGGGGGGGGWGGWGGGGGGGGGGGGGGWGGGGGWGGW
WWWWGGWGGWWWWWWWGGWWWWWWWWWWGGWGGWGGWGGWGGWGGWGGWWWWGGWGGWGGWWWWWWWWWWGGWWWWGGWWWWWWWGGWWWWWWWGGWGGWGGWWWWWWWWWWWWWGGWGGW
WGGGGGWGGWGGGGGWGGGGGGGGGGGWGGWGGWGGWGGWGGWGGWGGGGGWGGWGGWGGGGGWGGGGGWGGWGGWGGGGGWGGGGGWGGGGGGGGWGGWGGGGGGGGGGGGGGGGGWGGW
WWWWWWWWWWGGWWWWGGWWWWWWWWWWWWWGGWGGWWWWGGWGGWGGWGGWGGWGGWGGWGGWWWWGGWWWWGGWWWWGGWGGWWWWGGWWWWWWWWWWWWWGGWWWWWWWWWWWWWGGW
WGGGGGGGGWGGWGGGGGGGGWGGGGGWGGWGGGGGGGGWGGGGGGGGWGGWGGWGGWGGWGGGGGWGGGGGGGGWGGGGGGGGGGGGGGWGGGGGWGGGGGWGGGGGWGGWGGGGGGGGW
WGGWWWWWWWGGWGGWWWWGGWGGWWWWGGWWWWGGWWWWGGWWWWGGWGGWGGWGGWGGWGGWWWWWWWWWWGGWGGWWWWWWWWWWWWWWWWGGWGGWWWWGGWGGWGGWGGWGGWWWW
WGGGGGGGGWGGGGGGGGWGGGGGWGGWGGGGGWGGGGGWGGWGGGGGWGGWGGWGGWGGWGGGGGWGGGGGGGGGGGWGGWGGGGGGGGGGGGGGGGGWGGWGGWGGGGGWGGWGGGGGW
WGGWWWWWWWWWWWWWGGWGGWGGWGGWWWWGGWGGWWWWGGWWWWWWWWWWGGWWWWWWWGGWGGWGGWWWWWWWGGWGGWGGWGGWWWWWWWGGWWWWGGWGGWWWWWWWGGWWWWGGW
WGGGGGWGGGGGWGGWGGWGGWGGGGGGGGWGGGGGWGGGGGWGGGGGGGGWGGWGGWGGWGGWGGGGGWGGWGGGGGGGGGGGWGGGGGWGGGGGGGGGGGWGGWGGWGGWGGGGGWGGW
WWWWGGWGGWWWWGGWWWWGGWGGWGGWWWWWWWGGWGGWWWWWWWGGWWWWGGWGGWGGWWWWGGWWWWGGWWWWWWWWWWGGWWWWGGWWWWGGWWWWGGWGGWGGWGGWGGWWWWGGW
WGGGGGGGGWGGGGGGGGWGGWGGWGGGGGWGGGGGWGGGGGGGGWGGGGGWGGGGGGGGGGGGGGWGGGGGWGGWGGWGGGGGGGGWGGGGGWGGWGGGGGGGGWGGGGGWGGWGGGGGW
WWWWGGWWWWGGWWWWWWWWWWGGWWWWWWWGGWWWWWWWWWWWWWGGWWWWGGWGGWGGWGGWWWWWWWGGWGGWGGWGGWWWWWWWGGWGGWWWWWWWGGWGGWWWWGGWGGWWWWWWW
WGGGGGGGGGGGWGGGGGWGGGGGGGGWGGGGGWGGGGGWGGGGGWGGGGGGGGWGGWGGWGGWGGWGGWGGGGGGGGWGGGGGGGGWGGWGGWGGGGGGGGWGGWGGGGGGGGGGGWGGW
WWWWGGWWWWGGWGGWWWWWWWGGWWWWWWWGGWGGWWWWWWWGGWWWWWWWGGWWWWGGWGGWGGWGGWGGWWWWGGWWWWWWWGGWGGWWWWWWWWWWWWWWWWGGWWWWGGWGGWGGW
WGGGGGWGGGGGGGGGGGWGGGGGGGGWGGGGGGGGWGGWGGGGGGGGGGGGGGGGGWGGWGGWGGWGGGGGWGGGGGGGGGGGWGGWGGWGGGGGGGGGGGGGGGGGWGGGGGWGGGGGW
WGGWGGWWWWWWWWWWWWWGGWWWWWWWWWWWWWGGWGGWWWWWWWGGWGGWGGWGGWWWWGGWGGWGGWWWWGGWWWWWWWWWWGGWWWWGGWGGWGGWWWWWWWGGWGGWGGWWWWGGW
WGGWGGGGGWGGGGGWGGWGGGGGWGGWGGGGGGGGWGGGGGWGGGGGWGGWGGWGGWGGWGGGGGGGGGGGWGGGGGWGGGGGWGGWGGGGGWGGWGGWGGGGGWGGWGGWGGWGGGGGW
WGGWWWWWWWGGWGGWGGWGGWWWWGGWWWWWWWGGWWWWGGWWWWWWWWWWWWWWWWGGWGGWWWWGGWGGWWWWWWWWWWGGWGGWWWWWWWWWWGGWGGWWWWWWWWWWGGWWWWGGW
WGGGGGWGGGGGWGGGGGWGGWGGWGGGGGWGGWGGWGGGGGGGGGGGWGGWGGWGGGGGWGGWGGGGGWGGGGGWGGGGGWGGGGGGGGGGGWGGGGGGGGGGGGGGWGGGGGGGGWGGW
WGGWWWWGGWWWWWWWWWWGGWGGWGGWGGWGGWWWWWWWGGWGGWWWWGGWGGWWWWGGWGGWWWWWWWWWWWWWWWWGGWGGWGGWGGWWWWGGWGGWWWWWWWWWWWWWGGWGGWGGW
WGGWGGWGGGGGWGGGGGGGGGGGGGGWGGGGGWGGGGGWGGWGGGGGWGGGGGWGGGGGGGGWGGGGGGGGGGGGGGGGGWGGWGGWGGGGGGGGWGGWGGGGGGGGWGGWGGWGGWGGW
WGGWGGWGGWGGWWWWWWWWWWWWWGGWWWWWWWGGWWWWGGWWWWWWWGGWWWWGGWWWWWWWWWWGGWGGWWWWGGWWWWGGWWWWGGWWWWWWWWWWGGWWWWGGWGGWWWWWWWWWW
WGGWGGGGGWGGGGGGGGGGGGGGWGGGGGGGGWGGGGGGGGGGGWGGWGGGGGGGGGGGGGGWGGGGGWGGWGGWGGGGGGGGGGGWGGWGGGGGGGGGGGWGGWGGWGGGGGGGGGGGW
WGGWWWWGGWWWWWWWGGWGGWWWWGGWGGWGGWGGWWWWGGWGGWGGWGGWGGWWWWGGWWWWWWWGGWWWWGGWWWWWWWWWWWWWWWWWWWGGWGGWWWWGGWWWWGGWWWWWWWGGW
WGGGGGWGGGGGWGGGGGWGGWGGGGGWGGWGGWGGWGGWGGWGGGGGWGGWGGWGGGGGGGGWGGGGGGGGGGGGGGGGGGGGWGGGGGGGGWGGWGGGGGGGGWGGWGGGGGWGGWGGW
WWWWGGWGGWGGWWWWGGWGGWWWWGGWWWWWWWGGWGGWGGWGGWGGWGGWWWWWWWWWWWWWGGWWWWWWWGGWWWWWWWWWWGGWGGWWWWWWWGGWGGWGGWGGWGGWWWWGGWGGW
WGGGGGGGGWGGWGGGGGWGGGGGGGGGGGGGGWGGWGGGGGWGGWGGWGGWGGGGGWGGWGGWGGWGGWGGGGGGGGGGGWGGGGGWGGGGGGGGWGGWGGWGGGGGGGGWGGGGGGGGW
WWWWGGWGGWWWWWWWGGWWWWGGWWWWWWWWWWWWWGGWWWWWWWWWWGGWWWWGGWGGWGGWWWWGGWWWWGGWWWWGGWWWWWWWWWWGGWGGWGGWWWWWWWWWWWWWWWWGGWWWW
WGGWGGWGGWGGGGGGGGWGGGGGWGGWGGWGGWGGWGGGGGWGGGGGWGGWGGGGGGGGWGGWGGGGGGGGWGGWGGWGGGGGWGGGGGGGGWGGWGGGGGGGGGGGWGGGGGGGGWGGW
WGGWGGWWWWGGWGGWWWWWWWGGWGGWGGWGGWGGWGGWWWWWWWGGWWWWGGWGGWWWWGGWWWWWWWGGWWWWGGWGGWWWWWWWGGWGGWWWWGGWWWWWWWGGWWWWWWWWWWGGW
WGGWGGWGGGGGWGGGGGGGGWGGWGGGGGGGGGGGWGGWGGGGGGGGWGGGGGWGGWGGGGGWGGGGGGGGWGGGGGGGGWGGGGGGGGWGGGGGWGGWGGWGGGGGGGGWGGWGGGGGW
WGGWWWWWWWWWWWWWGGWWWWGGWGGWWWWWWWWWWGGWWWWGGWGGWGGWGGWGGWGGWWWWGGWGGWWWWWWWWWWGGWWWWWWWWWWGGWWWWWWWGGWWWWGGWWWWGGWGGWGGW
WGGWGGWGGGGGGGGGGGGGGWGGWGGGGGGGGWGGGGGWGGGGGWGGWGGWGGWGGGGGWGGGGGWGGGGGGGGWGGGGGGGGWGGWGGGGGGGGWGGWGGWGGGGGGGGWGGWGGWGGW
WGGWGGWGGWWWWGGWGGWGGWWWWWWWGGWWWWWWWGGWWWWWWWGGWWWWGGWWWWGGWGGWWWWWWWGGWWWWWWWWWWGGWGGWGGWGGWGGWGGWGGWWWWGGWGGWGGWWWWGGW
WGGGGGGGGGGGWGGWGGWGGWGGWGGGGGGGGWGGWGGGGGWGGGGGGGGWGGGGGWGGWGGGGGWGGGGGWGGWGGGGGGGGGGGGGGWGGWGGGGGGGGGGGGGGWGGWGGWGGGGGW
WGGWWWWWWWWWWWWWGGWWWWGGWGGWWWWWWWGGWGGWWWWWWWGGWGGWGGWWWWWWWGGWWWWGGWGGWGGWWWWWWWWWWWWWWWWGGWWWWGGWWWWGGWWWWWWWGGWWWWGGW
WGGWGGGGGGGGWGGWGGGGGGGGWGGGGGGGGGGGWGGGGGGGGGGGWGGGGGWGGGGGGGGWGGGGGWGGGGGWGGWGGGGGWGGWGGGGGWGGGGGGGGWGGWGGGGGGGGGGGWGGW
WGGWWWWGGWGGWGGWWWWGGWGGWWWWGGWWWWWWWGGWGGWWWWWWWGGWWWWWWWGGWWWWGGWWWWWWWGGWGGWGGWWWWGGWGGWWWWWWWWWWGGWWWWGGWGGWGGWWWWGGW
WGGGGGWGGWGGGGGWGGGGGWGGWGGGGGGGGWGGWGGWGGWGGWGGGGGGGGWGGWGGGGGWGGWGGWGGGGGGGGGGGGGGGGGWGGWGGGGGWGGGGGGGGWGGWGGWGGGGGWGGW
WGGWWWWWWWGGWGGWGGWWWWGGWGGWWWWWWWGGWGGWGGWGGWGGWGGWWWWGGWWWWWWWWWWGGWGGWWWWGGWWWWGGWGGWGGWGGWGGWWWWWWWGGWWWWWWWGGWGGWGGW
WGGWGGGGGGGGWGGGGGWGGGGGGGGGGGGGGGGGGGGWGGGGGWGGWGGGGGGGGGGGGGGWGGGGGGGGWGGGGGGGGWGGWGGGGGWGGWGGGGGGGGGGGGGGGGGGGGWGGGGGW
WWWWWWWWWWWWWWWWWWWWWWWWWWWWWWWWWWWWWWWWWWWWWWWWWWWWWWWWWWWWWWWWWWWWWWWWWWWWWWWWWWWWWWWWWWWWWWWWWWWWWWWWWWWWWWWWWWWWWWGTW
